index,img_url,prod_url,price,5,4,3,2,1,SUM
11,https://images.meesho.com/images/products/116747083/63fo0_400.webp,https://www.meesho.com/alisha-refined-kurtis/p/1xiamj,₹293,4613,1864,1622,1104,2248,11451
12,https://images.meesho.com/images/products/70794568/fhoum_400.webp,https://www.meesho.com/abhisarika-attractive-kurtis/p/165dfs,₹465,4572,2037,1535,968,2379,11491
13,https://images.meesho.com/images/products/80710539/hntyn_400.webp,https://www.meesho.com/kashvi-drishya-kurtis/p/1c1wnf,₹308,13031,4742,3644,1860,2789,26066
14,https://images.meesho.com/images/products/175026460/myoew_400.webp,https://www.meesho.com/chitrarekha-refined-kurtis/p/2w7fa4,₹429,765,321,221,117,210,1634
15,https://images.meesho.com/images/products/42021264/aikrx_400.webp,https://www.meesho.com/abhisarika-voguish-kurtis/p/p0ntc,₹583,4130,1900,1243,712,1760,9745
16,https://images.meesho.com/images/products/144179833/rcape_400.webp,https://www.meesho.com/myra-ensemble-kurtis/p/2du9vd,₹285,547,262,186,99,164,1258
17,https://images.meesho.com/images/products/70099091/bb3nm_400.webp,https://www.meesho.com/jivika-graceful-kurtis/p/15qgsz,₹429,1473,729,510,346,695,3753
18,https://images.meesho.com/images/products/143647181/7dccf_400.webp,https://www.meesho.com/chitrarekha-attractive-kurtis/p/2diuvh,₹550,866,310,223,146,252,1797
19,https://images.meesho.com/images/products/108045389/ifww7_400.webp,https://www.meesho.com/aishani-attractive-kurtis/p/1sbsct,₹512,932,342,218,104,211,1807
110,https://images.meesho.com/images/products/140686501/ryul2_400.webp,https://www.meesho.com/aakarsha-petite-kurtis/p/2breed,₹507,1041,444,301,181,427,2394
111,https://images.meesho.com/images/products/130178699/epbzd_400.webp,https://www.meesho.com/aakarsha-refined-kurtis/p/25i6iz,₹287,228,102,102,48,121,601
112,https://images.meesho.com/images/products/24724573/40a76_400.webp,https://www.meesho.com/adrika-voguish-kurtis/p/epxlp,₹536,2820,1036,299,82,152,4389
113,https://images.meesho.com/images/products/194217074/nykuo_400.webp,https://www.meesho.com/myra-fabulous-kurtis/p/37mquq,₹348,106,41,24,15,23,209
114,https://images.meesho.com/images/products/171256350/dwktq_400.webp,https://www.meesho.com/aakarsha-ensemble-kurtis/p/2tym8u,₹288,61,39,31,14,21,166
115,https://images.meesho.com/images/products/183835713/sjhwv_400.webp,https://www.meesho.com/aagam-drishya-kurtis/p/31g8jl,₹302,570,296,177,73,109,1225
116,https://images.meesho.com/images/products/132621645/yv7nk_400.webp,https://www.meesho.com/aishani-alluring-kurtis/p/26yjil,₹302,917,381,310,168,283,2059
117,https://images.meesho.com/images/products/50690921/tqg3z_400.webp,https://www.meesho.com/charvi-superior-kurtis/p/u6hd5,₹359,1393,609,428,190,424,3044
118,https://images.meesho.com/images/products/188096009/dvqeu_400.webp,https://www.meesho.com/chitrarekha-drishya-kurtis/p/33zjt5,₹278,160,66,56,44,81,407
119,https://images.meesho.com/images/products/164054970/x4tk4_400.webp,https://www.meesho.com/aagam-fashionable-kurtis/p/2po9mi,₹307,155,78,55,27,60,375
120,https://images.meesho.com/images/products/60728385/0dgl5_400.webp,https://www.meesho.com/trendy-fashionable-kurtis/p/105mbl,₹567,2122,899,671,402,958,5052
21,https://images.meesho.com/images/products/112259612/iud6q_400.webp,https://www.meesho.com/chitrarekha-voguish-kurtis/p/1uu42k,₹450,373,129,84,49,102,737
22,https://images.meesho.com/images/products/140769098/6iqmj_400.webp,https://www.meesho.com/banita-sensational-kurtis/p/2bt64q,₹716,939,316,217,101,291,1864
23,https://images.meesho.com/images/products/154078712/0gk8l_400.webp,https://www.meesho.com/aishani-drishya-kurtis/p/2jqfw8,₹248,258,108,84,58,130,638
24,https://images.meesho.com/images/products/146339573/1f5gk_400.webp,https://www.meesho.com/alisha-pretty-kurtis/p/2f4kc5,₹506,523,233,169,109,251,1285
25,https://images.meesho.com/images/products/157925172/lblqn_400.webp,https://www.meesho.com/chitrarekha-fashionable-kurtis/p/2m0vuc,₹665,388,148,79,47,105,767
26,https://images.meesho.com/images/products/92823380/wpizr_400.webp,https://www.meesho.com/charvi-superior-kurtis/p/1j9iz8,₹448,811,414,258,162,336,1981
27,https://images.meesho.com/images/products/90900386/brpv0_400.webp,https://www.meesho.com/banita-refined-kurtis/p/1i4b6q,₹481,1166,481,278,156,288,2369
28,https://images.meesho.com/images/products/56633194/yi91t_400.webp,https://www.meesho.com/kashvi-superior-kurtis/p/xpuga,₹385,5567,2505,1147,621,1048,10888
29,https://images.meesho.com/images/products/177667452/dnwmp_400.webp,https://www.meesho.com/aishani-pretty-kurtis/p/2xs130,₹357,141,68,30,17,21,277
210,https://images.meesho.com/images/products/182013478/h4yox_400.webp,https://www.meesho.com/myra-pretty-kurtis/p/30d6hy,₹556,470,201,140,70,177,1058
211,https://images.meesho.com/images/products/194061979/iwumt_400.webp,https://www.meesho.com/trendy-superior-kurtis/p/37jf6j,₹246,100,37,26,11,26,200
212,https://images.meesho.com/images/products/14054446/0a08f_400.webp,https://www.meesho.com/women-georgette-straight-chikankari-yellow-kurti/p/8d8ha,₹515,4858,2238,1513,892,2072,11573
213,https://images.meesho.com/images/products/106752488/nz4j4_400.webp,https://www.meesho.com/trendy-sensational-kurtis/p/1rk2qw,₹831,1718,696,472,286,623,3795
214,https://images.meesho.com/images/products/70718027/peeyx_400.webp,https://www.meesho.com/trendy-sensational-kurtis/p/163qdn,₹431,867,418,257,174,371,2087
215,https://images.meesho.com/images/products/73654281/mmb3m_400.webp,https://www.meesho.com/abhisarika-petite-kurtis/p/17uo09,₹476,771,381,249,113,209,1723
216,https://images.meesho.com/images/products/180062330/nmc4v_400.webp,https://www.meesho.com/aagyeyi-petite-kurtis/p/2z7cze,₹591,265,111,64,42,85,567
217,https://images.meesho.com/images/products/118813393/nf5f9_400.webp,https://www.meesho.com/jivika-voguish-kurtis/p/1yql01,₹462,986,395,307,204,487,2379
218,https://images.meesho.com/images/products/105632864/8ekox_400.webp,https://www.meesho.com/aagam-ensemble-kurtis/p/1qw2u8,₹439,65,31,24,17,36,173
219,https://images.meesho.com/images/products/185166513/rk2i5_400.webp,https://www.meesho.com/aishani-sensational-kurtis/p/328re9,₹286,126,75,42,23,52,318
220,https://images.meesho.com/images/products/73315607/ciiuv_400.webp,https://www.meesho.com/kashvi-attractive-kurtis/p/17neon,₹487,436,182,138,71,144,971
31,https://images.meesho.com/images/products/75292110/n9gs6_400.webp,https://www.meesho.com/kashvi-refined-kurtis/p/18trri,₹502,1369,630,400,233,527,3159
32,https://images.meesho.com/images/products/50834248/pm6aa_400.webp,https://www.meesho.com/aagam-fashionable-kurtis/p/u9jyg,₹333,4773,2067,1580,966,2066,11452
33,https://images.meesho.com/images/products/54193685/iutgs_400.webp,https://www.meesho.com/aishani-attractive-kurtis/p/w9k45,₹473,2342,1069,690,421,772,5294
34,https://images.meesho.com/images/products/188367306/xuojk_400.webp,https://www.meesho.com/aishani-attractive-kurtis/p/345d56,₹250,254,119,93,37,67,570
35,https://images.meesho.com/images/products/159894531/2tpaq_400.webp,https://www.meesho.com/alisha-voguish-kurtis/p/2n73er,₹560,147,57,34,27,71,336
36,https://images.meesho.com/images/products/60018108/fm4uq_400.webp,https://www.meesho.com/chitrarekha-ensemble-kurtis/p/zqe9o,₹599,444,194,134,66,151,989
37,https://images.meesho.com/images/products/121281274/iy2qy_400.webp,https://www.meesho.com/adrika-refined-kurtis/p/207h8a,₹290,51,13,23,10,28,125
38,https://images.meesho.com/images/products/135212696/rhc6q_400.webp,https://www.meesho.com/jivika-refined-kurtis/p/28i2s8,₹360,511,178,83,42,100,914
39,https://images.meesho.com/images/products/49013607/totcg_400.webp,https://www.meesho.com/adrika-petite-kurtis/p/t6j53,₹261,50,26,14,9,18,117
310,https://images.meesho.com/images/products/187665203/c6onb_400.webp,https://www.meesho.com/banita-refined-kurtis/p/33qbeb,₹343,0,0,0,0,0,0
311,https://images.meesho.com/images/products/61528346/mnib7_400.webp,https://www.meesho.com/trendy-fashionable-kurtis/p/10mrkq,₹566,336,208,123,70,156,893
312,https://images.meesho.com/images/products/126238293/ixh5d_400.webp,https://www.meesho.com/festive-special-banita-attractive-kurtis/p/235q39,₹495,3399,1237,526,276,525,5963
313,https://images.meesho.com/images/products/144205183/fvcca_400.webp,https://www.meesho.com/aishani-fashionable-kurtis/p/2dutfj,₹292,126,71,43,21,36,297
314,https://images.meesho.com/images/products/67943969/rvece_400.webp,https://www.meesho.com/aagyeyi-fabulous-kurtis/p/14g9wh,₹567,262,113,80,55,131,641
315,https://images.meesho.com/images/products/73593470/udvgs_400.webp,https://www.meesho.com/trendy-graceful-kurtis/p/17td32,₹469,498,210,143,86,174,1111
316,https://images.meesho.com/images/products/66952688/1a7ey_400.webp,https://www.meesho.com/kashvi-refined-kurtis/p/13v10w,₹425,234,101,73,51,84,543
317,https://images.meesho.com/images/products/63650158/ciswv_400.webp,https://www.meesho.com/adrika-alluring-kurtis/p/11w8ry,₹430,374,182,106,83,141,886
318,https://images.meesho.com/images/products/72250006/c0kym_400.webp,https://www.meesho.com/womens-lucknowi-chikankari-chiffon-kurtis-with-inner/p/170kgm,₹412,1076,506,315,180,500,2577
319,https://images.meesho.com/images/products/45265317/nb5vm_400.webp,https://www.meesho.com/jivika-superior-kurtis/p/qy6xx,₹433,336,192,123,83,146,880
320,https://images.meesho.com/images/products/112541896/tfgdx_400.webp,https://www.meesho.com/abhisarika-attractive-kurtis/p/1v05vs,₹579,2004,751,343,185,324,3607
41,https://images.meesho.com/images/products/100128517/06tvm_400.webp,https://www.meesho.com/aagam-fashionable-kurtis/p/1nm3np,₹444,576,223,153,77,160,1189
42,https://images.meesho.com/images/products/67208656/pbflm_400.webp,https://www.meesho.com/alisha-sensational-kurtis/p/140ij4,₹299,3348,1557,1246,784,1521,8456
43,https://images.meesho.com/images/products/47246940/u5rx4_400.webp,https://www.meesho.com/trendy-pretty-kurtis/p/s4nz0,₹581,722,276,183,124,262,1567
44,https://images.meesho.com/images/products/78614417/vymmb_400.webp,https://www.meesho.com/aishani-drishya-kurtis/p/1asz9t,₹378,361,187,141,101,196,986
45,https://images.meesho.com/images/products/79787892/qnmjb_400.webp,https://www.meesho.com/alisha-refined-kurtis/p/1bi4qc,₹493,205,120,60,30,73,488
46,https://images.meesho.com/images/products/63854715/rwzkn_400.webp,https://www.meesho.com/festive-special-aagyeyi-fabulous-kurtis/p/120mm3,₹304,720,334,260,170,279,1763
47,https://images.meesho.com/images/products/150671802/d4lye_400.webp,https://www.meesho.com/kashvi-graceful-kurtis/p/2hpf3u,₹321,23,8,12,6,7,56
48,https://images.meesho.com/images/products/186383790/hmput_400.webp,https://www.meesho.com/comfy-women-kurtis/p/32yuni,₹533,103,43,12,12,20,190
49,https://images.meesho.com/images/products/62777299/zxhsc_400.webp,https://www.meesho.com/kashvi-superior-kurtis/p/11dj9v,₹385,147,59,55,30,61,352
410,https://images.meesho.com/images/products/66047494/vpbmw_400.webp,https://www.meesho.com/myra-petite-kurtis/p/13bmkm,₹422,1034,426,335,211,403,2409
411,https://images.meesho.com/images/products/112386573/wur8q_400.webp,https://www.meesho.com/abhisarika-attractive-kurtis/p/1uwu19,₹539,376,171,112,84,156,899
412,https://images.meesho.com/images/products/174841952/jyhdr_400.webp,https://www.meesho.com/adrika-alluring-kurtis/p/2w3gww,₹380,92,44,39,19,48,242
413,https://images.meesho.com/images/products/17174457/1fbc8_400.webp,https://www.meesho.com/trendy-ensemble-kurtis/p/a83w9,₹455,348,154,88,53,125,768
414,https://images.meesho.com/images/products/182054393/tym47_400.webp,https://www.meesho.com/myra-graceful-kurtis/p/30e22h,₹562,280,101,57,33,108,579
415,https://images.meesho.com/images/products/164577021/xx8nr_400.webp,https://www.meesho.com/adrika-drishya-kurtis/p/2pzgfx,₹556,241,103,69,30,81,524
416,https://images.meesho.com/images/products/43158705/bekre_400.webp,https://www.meesho.com/myra-fashionable-kurtis/p/pp1gx,₹610,378,198,121,76,162,935
417,https://images.meesho.com/images/products/164798401/xdlmd_400.webp,https://www.meesho.com/abhisarika-fabulous-kurtis/p/2q479d,₹541,592,228,149,90,173,1232
418,https://images.meesho.com/images/products/176579862/7doc5_400.webp,https://www.meesho.com/aishani-graceful-kurtis/p/2x4pw6,₹273,4,1,0,0,1,6
419,https://images.meesho.com/images/products/144187462/qxaxo_400.webp,https://www.meesho.com/aagam-graceful-kurtis/p/2dufra,₹286,369,169,116,70,132,856
420,https://images.meesho.com/images/products/20399233/f0141_400.webp,https://www.meesho.com/jivika-attractive-kurtis/p/c585d,₹532,996,460,231,89,161,1937
51,https://images.meesho.com/images/products/141159758/2jvu5_400.webp,https://www.meesho.com/abhisarika-refined-kurtis/p/2c1jke,₹512,458,182,148,98,199,1085
52,https://images.meesho.com/images/products/7758476/3c96a_400.webp,https://www.meesho.com/women-chiffon-yellow-kurti/p/4mah8,₹535,838,328,226,132,348,1872
53,https://images.meesho.com/images/products/111644749/hujya_400.webp,https://www.meesho.com/aagam-fabulous-kurtis/p/1ugxn1,₹459,629,250,137,63,159,1238
54,https://images.meesho.com/images/products/7701992/dc9ee_400.webp,https://www.meesho.com/charvi-pretty-kurtis/p/4l2w8,₹544,429,211,163,92,197,1092
55,https://images.meesho.com/images/products/143924950/by1lq_400.webp,https://www.meesho.com/myra-graceful-kurtis/p/2dot7a,₹294,379,132,134,84,159,888
56,https://images.meesho.com/images/products/177070946/5uckm_400.webp,https://www.meesho.com/aakarsha-graceful-kurtis/p/2xf8te,₹746,312,105,77,47,103,644
57,https://images.meesho.com/images/products/145013883/nkmbh_400.webp,https://www.meesho.com/aagam-drishya-kurtis/p/2ec5ff,₹533,305,141,101,57,122,726
58,https://images.meesho.com/images/products/84276531/berxv_400.webp,https://www.meesho.com/abhisarika-fabulous-kurtis/p/1e6c6r,₹455,140,35,30,21,61,287
59,https://images.meesho.com/images/products/71107727/bpjdv_400.webp,https://www.meesho.com/trendy-refined-kurtis/p/16c32n,₹290,1020,475,373,305,541,2714
510,https://images.meesho.com/images/products/108037664/irw3c_400.webp,https://www.meesho.com/aishani-petite-kurtis/p/1sbme8,₹516,214,72,38,24,40,388
511,https://images.meesho.com/images/products/55272000/pakcb_400.webp,https://www.meesho.com/chitrarekha-drishya-kurtis/p/wwo5c,₹556,1138,530,326,170,357,2521
512,https://images.meesho.com/images/products/146341116/mzwzy_400.webp,https://www.meesho.com/aakarsha-fashionable-kurtis/p/2f4lj0,₹532,225,83,81,37,113,539
513,https://images.meesho.com/images/products/19558871/f0535_400.webp,https://www.meesho.com/women-cotton-mustard-kurti/p/bn7pz,₹532,1956,876,439,161,257,3689
514,https://images.meesho.com/images/products/129312083/alwmb_400.webp,https://www.meesho.com/aakarsha-attractive-kurtis/p/24zlub,₹284,1121,584,446,312,577,3040
515,https://images.meesho.com/images/products/145334482/psbiq_400.webp,https://www.meesho.com/adrika-graceful-kurtis/p/2ej0sy,₹458,82,31,29,23,42,207
516,https://images.meesho.com/images/products/164408177/wily9_400.webp,https://www.meesho.com/chitrarekha-fabulous-kurtis/p/2pvu5t,₹338,5,3,2,2,1,13
517,https://images.meesho.com/images/products/182520923/eixoc_400.webp,https://www.meesho.com/aakarsha-graceful-kurtis/p/30o21n,₹561,244,90,61,40,82,517
518,https://images.meesho.com/images/products/146066097/hdzl9_400.webp,https://www.meesho.com/adrika-refined-kurtis/p/2eypbl,₹391,222,79,36,20,22,379
519,https://images.meesho.com/images/products/47616000/vmtjz_400.webp,https://www.meesho.com/charvi-voguish-kurtis/p/sckqo,₹576,819,356,216,104,304,1799
520,https://images.meesho.com/images/products/132345062/klkly_400.webp,https://www.meesho.com/trendy-fashionable-kurtis/p/26sm3q,₹378,1617,547,347,170,336,3017
61,https://images.meesho.com/images/products/166017747/xeqjl_400.webp,https://www.meesho.com/adrika-graceful-kurtis/p/2quc43,₹362,87,29,32,12,35,195
62,https://images.meesho.com/images/products/133838915/iptol_400.webp,https://www.meesho.com/aagyeyi-fashionable-kurtis/p/27omrn,₹182,182,82,39,23,33,359
63,https://images.meesho.com/images/products/77707888/t5vdb_400.webp,https://www.meesho.com/charvi-petite-kurtis/p/1a9jsg,₹596,847,369,262,140,312,1930
64,https://images.meesho.com/images/products/196307543/mhyxk_400.webp,https://www.meesho.com/myra-petite-kurtis/p/38vjvb,₹293,53,24,14,20,25,136
65,https://images.meesho.com/images/products/140962692/e29uh_400.webp,https://www.meesho.com/charvi-voguish-kurtis/p/2bxbic,₹496,179,88,72,35,57,431
66,https://images.meesho.com/images/products/70902403/7n4nu_400.webp,https://www.meesho.com/alisha-sensational-kurtis/p/167on7,₹515,195,98,63,47,85,488
67,https://images.meesho.com/images/products/12104190/98adb_400.webp,https://www.meesho.com/banita-graceful-kurtis/p/77fni,₹565,8295,3806,2282,1279,2541,18203
68,https://images.meesho.com/images/products/55684505/mnekp_400.webp,https://www.meesho.com/myra-attractive-kurtis/p/x5ift,"₹1,015",645,217,87,47,94,1090
69,https://images.meesho.com/images/products/152563817/akaup_400.webp,https://www.meesho.com/myra-drishya-kurtis/p/2ityzt,₹297,44,14,15,7,21,101
610,https://images.meesho.com/images/products/19912107/6a912_400.webp,https://www.meesho.com/adrika-graceful-kurtis/p/busa3,₹616,1681,624,301,163,186,2955
611,https://images.meesho.com/images/products/145738895/dtigj_400.webp,https://www.meesho.com/trendy-alluring-kurtis/p/2eroun,₹447,38,22,16,6,19,101
612,https://images.meesho.com/images/products/116527978/zzwgz_400.webp,https://www.meesho.com/aakarsha-drishya-kurtis/p/1xdlka,₹362,362,148,87,38,64,699
613,https://images.meesho.com/images/products/130762401/zk8mt_400.webp,https://www.meesho.com/aishani-alluring-kurtis/p/25uowx,₹362,150,38,27,18,37,270
614,https://images.meesho.com/images/products/93014309/hbllo_400.webp,https://www.meesho.com/aagyeyi-graceful-kurtis/p/1jdmat,₹450,121,61,29,20,29,260
615,https://images.meesho.com/images/products/153258528/uubcq_400.webp,https://www.meesho.com/alisha-attractive-kurtis/p/2j8v1c,₹282,71,33,16,11,7,138
616,https://images.meesho.com/images/products/191922301/xasb0_400.webp,https://www.meesho.com/aakarsha-drishya-kurtis/p/369k71,₹686,15,7,6,0,4,32
617,https://images.meesho.com/images/products/135808321/bps4z_400.webp,https://www.meesho.com/adrika-fabulous-kurtis/p/28uudd,₹471,265,129,60,33,53,540
618,https://images.meesho.com/images/products/177666422/wtqvj_400.webp,https://www.meesho.com/aagyeyi-fabulous-kurtis/p/2xs0ae,₹353,328,96,72,42,67,605
619,https://images.meesho.com/images/products/172635438/jqt49_400.webp,https://www.meesho.com/charvi-graceful-kurtis/p/2us6cu,₹468,3,2,0,1,1,7
620,https://images.meesho.com/images/products/197380397/ia2d9_400.webp,https://www.meesho.com/aishani-fashionable-kurtis/p/39ijot,₹638,15,5,4,2,7,33
71,https://images.meesho.com/images/products/135654801/140xs_400.webp,https://www.meesho.com/charvi-petite-kurtis/p/28rjwx,₹315,684,258,189,108,209,1448
72,https://images.meesho.com/images/products/96864090/50bpu_400.webp,https://www.meesho.com/banita-drishya-kurtis/p/1lo4t6,"₹1,015",367,155,58,39,52,671
73,https://images.meesho.com/images/products/146506489/y9twz_400.webp,https://www.meesho.com/kashvi-attractive-kurtis/p/2f854p,₹363,189,85,49,19,32,374
74,https://images.meesho.com/images/products/180873285/npbwr_400.webp,https://www.meesho.com/alisha-fashionable-kurtis/p/2zoqpx,₹462,111,36,41,25,45,258
75,https://images.meesho.com/images/products/11582205/02984_400.webp,https://www.meesho.com/abhisarika-fabulous-kurtis/p/6w8vx,₹535,2380,1004,669,458,913,5424
76,https://images.meesho.com/images/products/42019967/crefq_400.webp,https://www.meesho.com/charvi-pretty-kurtis/p/p0mtb,₹615,776,356,256,147,326,1861
77,https://images.meesho.com/images/products/53795246/nkzo5_400.webp,https://www.meesho.com/alisha-alluring-kurtis/p/w10oe,₹397,181,87,63,40,85,456
78,https://images.meesho.com/images/products/76272730/qtpo6_400.webp,https://www.meesho.com/banita-superior-kurtis/p/19esey,₹532,106,52,23,13,21,215
79,https://images.meesho.com/images/products/141725593/ewbsl_400.webp,https://www.meesho.com/kashvi-fashionable-kurtis/p/2cdo61,₹414,188,59,21,9,18,295
710,https://images.meesho.com/images/products/19579455/839b0_400.webp,https://www.meesho.com/aishani-fashionable-kurtis/p/bnnlr,₹532,1127,532,259,106,158,2182
711,https://images.meesho.com/images/products/185394423/wtlog_400.webp,https://www.meesho.com/trendy-fashionable-kurtis/p/32dn93,₹307,0,1,3,1,2,7
712,https://images.meesho.com/images/products/141277890/n8fsk_400.webp,https://www.meesho.com/kashvi-drishya-kurtis/p/2c42pu,₹726,87,24,30,13,23,177
713,https://images.meesho.com/images/products/71440436/9rr7z_400.webp,https://www.meesho.com/banita-superior-kurtis/p/16j7sk,₹507,173,69,41,22,26,331
714,https://images.meesho.com/images/products/183035919/5gl5v_400.webp,https://www.meesho.com/aagyeyi-drishya-kurtis/p/30z3f3,₹441,0,0,0,0,0,0
715,https://images.meesho.com/images/products/196560705/zcymk_400.webp,https://www.meesho.com/abhisarika-attractive-kurtis/p/390z7l,₹636,27,14,1,4,14,60
716,https://images.meesho.com/images/products/164438823/csanz_400.webp,https://www.meesho.com/abhisarika-fashionable-kurtis/p/2pwht3,₹444,143,38,14,9,10,214
717,https://images.meesho.com/images/products/187882909/htlj0_400.webp,https://www.meesho.com/aishani-drishya-kurtis/p/33uzdp,₹677,60,19,10,8,17,114
718,https://images.meesho.com/images/products/140226875/fj4pi_400.webp,https://www.meesho.com/aakarsha-ensemble-kurtis/p/2bhjqz,₹543,276,117,95,49,119,656
719,https://images.meesho.com/images/products/138100807/djzhj_400.webp,https://www.meesho.com/alisha-fashionable-kurtis/p/2a7z9j,₹393,282,106,61,38,95,582
720,https://images.meesho.com/images/products/145676011/emcsn_400.webp,https://www.meesho.com/abhisarika-petite-kurtis/p/2eqcbv,"₹1,091",241,101,79,43,117,581
81,https://images.meesho.com/images/products/59576605/ecnyh_400.webp,https://www.meesho.com/aakarsha-petite-kurtis/p/zgxlp,₹523,1162,444,317,184,428,2535
82,https://images.meesho.com/images/products/193776176/kxdil_400.webp,https://www.meesho.com/jivika-graceful-kurtis/p/37dank,₹637,41,19,10,9,15,94
83,https://images.meesho.com/images/products/72108889/2yvd3_400.webp,https://www.meesho.com/aagam-fabulous-kurtis/p/16xjkp,₹289,2793,1192,1051,741,1376,7153
84,https://images.meesho.com/images/products/83784666/7q8on_400.webp,https://www.meesho.com/trendy-fabulous-kurtis/p/1dvsnu,₹454,371,138,119,72,141,841
85,https://images.meesho.com/images/products/154437951/9rqx1_400.webp,https://www.meesho.com/charvi-attractive-kurtis/p/2jy533,₹295,48,8,15,9,23,103
86,https://images.meesho.com/images/products/187784159/cijmu_400.webp,https://www.meesho.com/banita-attractive-kurtis/p/33sv6n,₹545,67,35,21,14,39,176
87,https://images.meesho.com/images/products/144198538/mxvo4_400.webp,https://www.meesho.com/jivika-ensemble-kurtis/p/2duoay,₹284,801,352,284,156,249,1842
88,https://images.meesho.com/images/products/101102758/enx9l_400.webp,https://www.meesho.com/aagam-pretty-kurtis/p/1o6zdy,₹499,70,44,19,8,27,168
89,https://images.meesho.com/images/products/50839940/eidp5_400.webp,https://www.meesho.com/myra-fashionable-kurtis/p/u9ock,₹333,213,91,79,44,80,507
810,https://images.meesho.com/images/products/157924711/cw6oj_400.webp,https://www.meesho.com/aakarsha-ensemble-kurtis/p/2m0vhj,₹565,46,25,18,9,22,120
811,https://images.meesho.com/images/products/159808495/f6txb_400.webp,https://www.meesho.com/aagyeyi-sensational-kurtis/p/2n590v,₹370,12,5,1,2,3,23
812,https://images.meesho.com/images/products/73308568/2dlvy_400.webp,https://www.meesho.com/adrika-petite-chiffon-women-kurtis/p/17n994,₹496,199,80,44,31,57,411
813,https://images.meesho.com/images/products/181957607/mj5pc_400.webp,https://www.meesho.com/banita-refined-kurtis/p/30bzdz,₹367,82,47,23,14,29,195
814,https://images.meesho.com/images/products/167300203/nffnx_400.webp,https://www.meesho.com/charvi-refined-kurtis/p/2rltnv,₹444,26,16,7,6,4,59
815,https://images.meesho.com/images/products/69035985/t8uci_400.webp,https://www.meesho.com/chitrarekha-voguish-kurtis/p/153oi9,₹369,69,33,27,20,38,187
816,https://images.meesho.com/images/products/115895497/bkjyg_400.webp,https://www.meesho.com/myra-graceful-kurtis/p/1x01jd,₹570,62,27,17,16,27,149
817,https://images.meesho.com/images/products/43843499/xjjnd_400.webp,https://www.meesho.com/banita-fabulous-kurtis/p/q3puz,₹865,257,95,34,25,49,460
818,https://images.meesho.com/images/products/59082779/mjmwb_400.webp,https://www.meesho.com/aagam-pretty-kurtis/p/z6ckb,₹499,48,20,10,12,14,104
819,https://images.meesho.com/images/products/175441716/qhato_400.webp,https://www.meesho.com/aagyeyi-superior-kurtis/p/2wgbp0,₹816,44,12,7,7,23,93
820,https://images.meesho.com/images/products/139266836/wfn6x_400.webp,https://www.meesho.com/abhisarika-ensemble-kurtis/p/2awyz8,₹420,47,20,13,5,8,93
91,https://images.meesho.com/images/products/172445772/nguva_400.webp,https://www.meesho.com/aagyeyi-pretty-kurtis/p/2uo40c,₹491,90,43,23,16,31,203
92,https://images.meesho.com/images/products/33975579/kn4gx_400.webp,https://www.meesho.com/banita-superior-kurtis/p/k87q3,₹323,661,232,146,67,110,1216
93,https://images.meesho.com/images/products/108976161/d7gsc_400.webp,https://www.meesho.com/aakarsha-drishya-kurtis/p/1svqjl,₹310,46,21,7,11,10,95
94,https://images.meesho.com/images/products/160035069/ivnyx_400.webp,https://www.meesho.com/banita-alluring-kurtis/p/2na3ul,₹686,123,46,32,20,42,263
95,https://images.meesho.com/images/products/142393610/pv9rw_400.webp,https://www.meesho.com/aagyeyi-superior-kurtis/p/2crzm2,₹538,237,77,70,45,113,542
96,https://images.meesho.com/images/products/144214717/8gw2d_400.webp,https://www.meesho.com/kashvi-fashionable-kurtis/p/2dv0sd,₹293,298,125,97,65,82,667
97,https://images.meesho.com/images/products/107511690/20hkf_400.webp,https://www.meesho.com/jivika-fabulous-women-kurti/p/1s0cju,"₹1,223",124,40,30,16,35,245
98,https://images.meesho.com/images/products/167914867/jwqrl_400.webp,https://www.meesho.com/aakarsha-fabulous-kurtis/p/2ryzxv,₹362,0,0,0,0,0,0
99,https://images.meesho.com/images/products/62584355/ygp5z_400.webp,https://www.meesho.com/aagam-attractive-kurtis/p/119eeb,₹296,53,18,14,16,23,124
910,https://images.meesho.com/images/products/74704735/xdsgd_400.webp,https://www.meesho.com/charvi-fashionable-kurtis/p/18h6jj,₹294,674,281,258,164,294,1671
911,https://images.meesho.com/images/products/70288450/4hgss_400.webp,https://www.meesho.com/charvi-attractive-kurtis/p/15uiwy,₹477,391,146,71,22,48,678
912,https://images.meesho.com/images/products/42493677/hiyiv_400.webp,https://www.meesho.com/kashvi-attractive-kurtis/p/pasbx,₹486,4014,1776,976,514,703,7983
913,https://images.meesho.com/images/products/35654777/4bu5n_400.webp,https://www.meesho.com/chitrarekha-drishya-kurtis/p/l87eh,₹359,110,51,41,25,41,268
914,https://images.meesho.com/images/products/15525691/1cc6d_400.webp,https://www.meesho.com/charvi-alluring-kurtis/p/98rp7,₹653,271,113,92,46,70,592
915,https://images.meesho.com/images/products/45137276/cqhgm_400.webp,https://www.meesho.com/aakarsha-voguish-kurtis/p/qvg58,₹432,506,210,159,112,228,1215
916,https://images.meesho.com/images/products/155012226/07ydj_400.webp,https://www.meesho.com/aagyeyi-petite-kurtis/p/2kag76,₹464,135,54,34,21,47,291
917,https://images.meesho.com/images/products/114440609/zdxtm_400.webp,https://www.meesho.com/aagyeyi-pretty-kurtis/p/1w4uxt,₹515,198,109,54,25,71,457
918,https://images.meesho.com/images/products/70723374/6q7my_400.webp,https://www.meesho.com/adrika-fashionable-kurtis/p/163ui6,₹422,447,188,145,93,165,1038
919,https://images.meesho.com/images/products/171271824/o7oda_400.webp,https://www.meesho.com/jivika-attractive-kurtis/p/2tyy6o,₹503,21,8,1,2,5,37
920,https://images.meesho.com/images/products/191191370/g9tix_400.webp,https://www.meesho.com/jivika-graceful-kurtis/p/35tw7e,₹313,0,0,0,0,0,0
101,https://images.meesho.com/images/products/143145163/8tvlg_400.webp,https://www.meesho.com/adrika-superior-kurtis/p/2d83ij,₹450,22,8,11,3,11,55
102,https://images.meesho.com/images/products/195827730/gzze4_400.webp,https://www.meesho.com/aagyeyi-superior-kurtis/p/38l9n6,₹636,27,10,7,6,10,60
103,https://images.meesho.com/images/products/153091220/ga7b6_400.webp,https://www.meesho.com/alisha-alluring-kurtis/p/2j59xw,₹588,197,106,53,24,85,465
104,https://images.meesho.com/images/products/47351893/xwxu0_400.webp,https://www.meesho.com/myra-attractive-kurtis/p/s6wyd,₹292,72,42,24,16,34,188
105,https://images.meesho.com/images/products/108478667/k2yh9_400.webp,https://www.meesho.com/kashvi-petite-kurtis/p/1sl2ob,₹262,0,0,0,0,0,0
106,https://images.meesho.com/images/products/144389835/aaab5_400.webp,https://www.meesho.com/jivika-pretty-kurtis/p/2dyrwr,₹281,410,129,95,50,89,773
107,https://images.meesho.com/images/products/178035130/p3gea_400.webp,https://www.meesho.com/adrika-pretty-kurtis/p/2xzwsa,₹713,15,6,4,0,8,33
108,https://images.meesho.com/images/products/185398554/wp6lr_400.webp,https://www.meesho.com/charvi-ensemble-kurtis/p/32dqfu,₹407,5,1,1,0,0,7
109,https://images.meesho.com/images/products/181576814/csazv_400.webp,https://www.meesho.com/alisha-drishya-kurtis/p/303tke,₹461,12,8,4,2,5,31
1010,https://images.meesho.com/images/products/197010737/3sehp_400.webp,https://www.meesho.com/myra-voguish-kurtis/p/39amgh,₹561,38,18,8,3,17,84
1011,https://images.meesho.com/images/products/66954087/h5bmw_400.webp,https://www.meesho.com/aishani-fashionable-kurtis/p/13v23r,₹433,66,31,19,13,23,152
1012,https://images.meesho.com/images/products/78474770/23pvn_400.webp,https://www.meesho.com/adrika-ensemble-kurtis/p/1apziq,₹512,29,13,4,2,1,49
1013,https://images.meesho.com/images/products/36436434/kcjiu_400.webp,https://www.meesho.com/abhisarika-alluring-kurtis/p/loyj6,₹562,2357,1069,659,394,739,5218
1014,https://images.meesho.com/images/products/62049790/2tbr7_400.webp,https://www.meesho.com/chitrarekha-fabulous-kurtis/p/10xxxa,₹354,71,27,17,7,26,148
1015,https://images.meesho.com/images/products/149359909/d56xa_400.webp,https://www.meesho.com/adrika-alluring-kurtis/p/2gxaud,₹741,70,29,16,20,29,164
1016,https://images.meesho.com/images/products/185432394/ihvsg_400.webp,https://www.meesho.com/abhisarika-fabulous-kurtis/p/32egju,₹284,27,8,13,10,9,67
1017,https://images.meesho.com/images/products/177311121/pz2c3_400.webp,https://www.meesho.com/alisha-fashionable-kurtis/p/2xke4x,₹587,3,2,0,1,1,7
1018,https://images.meesho.com/images/products/58240072/hhkhz_400.webp,https://www.meesho.com/charvi-drishya-kurtis/p/yoabs,₹502,33,12,6,2,8,61
1019,https://images.meesho.com/images/products/45050339/1mixx_400.webp,https://www.meesho.com/kashvi-alluring-kurtis/p/qtl2b,₹455,523,247,165,91,155,1181
1020,https://images.meesho.com/images/products/130575994/lgglv_400.webp,https://www.meesho.com/aagyeyi-petite-kurtis/p/25qp2y,₹478,12,12,3,1,2,30
111,https://images.meesho.com/images/products/43831106/85q4z_400.webp,https://www.meesho.com/aishani-pretty-kurtis/p/q3gaq,₹464,17,12,6,2,7,44
112,https://images.meesho.com/images/products/146277204/evmeg_400.webp,https://www.meesho.com/attractive-georgette-embroidered-kurtis/p/2f387o,₹363,191,56,31,21,40,339
113,https://images.meesho.com/images/products/186407424/tqhjo_400.webp,https://www.meesho.com/aishani-petite-kurtis/p/32zcw0,₹503,29,6,12,4,10,61
114,https://images.meesho.com/images/products/156566115/sfiie_400.webp,https://www.meesho.com/trendy-fabulous-kurtis/p/2l7r6r,₹511,213,85,91,46,98,533
115,https://images.meesho.com/images/products/128800369/2bhvm_400.webp,https://www.meesho.com/banita-fashionable-kurtis/p/24on01,₹567,39,16,17,8,19,99
116,https://images.meesho.com/images/products/75026326/dsmiv_400.webp,https://www.meesho.com/adrika-sensational-kurtis/p/18o2om,₹532,106,41,22,7,19,195
117,https://images.meesho.com/images/products/81437848/pry0q_400.webp,https://www.meesho.com/chitrarekha-sensational-kurtis/p/1chhug,₹507,233,114,80,40,102,569
118,https://images.meesho.com/images/products/185985016/am29d_400.webp,https://www.meesho.com/charvi-fashionable-kurtis/p/32qayg,₹461,2,3,2,0,2,9
119,https://images.meesho.com/images/products/63310616/hpxcu_400.webp,https://www.meesho.com/banita-drishya-kurtis/p/11oys8,₹318,55,14,16,2,20,107
1110,https://images.meesho.com/images/products/80679263/nmn6c_400.webp,https://www.meesho.com/abhisarika-fabulous-kurtis/p/1c18in,₹499,490,160,90,57,87,884
1111,https://images.meesho.com/images/products/152412781/rd2c5_400.webp,https://www.meesho.com/alisha-fabulous-kurtis/p/2iqqgd,₹302,14,4,5,1,9,33
1112,https://images.meesho.com/images/products/142389583/k770q_400.webp,https://www.meesho.com/aagam-voguish-kurtis/p/2crwi7,₹533,68,33,15,11,26,153
1113,https://images.meesho.com/images/products/175021476/kpju6_400.webp,https://www.meesho.com/jivika-sensational-kurtis/p/2w7bfo,₹414,14,4,4,3,5,30
1114,https://images.meesho.com/images/products/71437459/hgpsz_400.webp,https://www.meesho.com/myra-petite-kurtis/p/16j5hv,₹507,70,20,14,9,13,126
1115,https://images.meesho.com/images/products/188961526/o5van_400.webp,https://www.meesho.com/banita-pretty-kurtis/p/34i3na,₹385,26,5,6,3,3,43
1116,https://images.meesho.com/images/products/68987257/eqdfi_400.webp,https://www.meesho.com/adrika-petite-kurtis/p/152mwp,₹326,17,6,9,5,3,40
1117,https://images.meesho.com/images/products/141660112/0j7um_400.webp,https://www.meesho.com/aagyeyi-attractive-kurtis/p/2cc9n4,₹464,38,15,6,2,3,64
1118,https://images.meesho.com/images/products/49888904/nwimm_400.webp,https://www.meesho.com/banita-voguish-kurtis/p/tpaiw,₹459,89,55,19,5,10,178
1119,https://images.meesho.com/images/products/169710275/pcyeo_400.webp,https://www.meesho.com/aishani-attractive-kurtis/p/2t1hab,₹686,36,16,9,4,5,70
1120,https://images.meesho.com/images/products/66296563/qphzu_400.webp,https://www.meesho.com/aakarsha-fashionable-kurtis/p/13gyr7,₹493,33,18,12,5,19,87
131,https://images.meesho.com/images/products/110957215/nf2dj_400.webp,https://www.meesho.com/aagam-alluring-kurtis/p/1u274v,₹495,83,33,10,10,15,151
132,https://images.meesho.com/images/products/64591920/zza4t_400.webp,https://www.meesho.com/festive-special-aagam-ensemble-kurtis/p/12gfg0,₹429,261,113,79,37,84,574
133,https://images.meesho.com/images/products/76726866/4a3kb_400.webp,https://www.meesho.com/adrika-refined-kurtis/p/19oitu,₹815,53,21,14,3,13,104
134,https://images.meesho.com/images/products/4694988/1_400.webp,https://www.meesho.com/aishani-alluring-kurtis/p/2smoc,₹392,1308,582,428,223,362,2903
135,https://images.meesho.com/images/products/165978053/hjvhi_400.webp,https://www.meesho.com/alisha-voguish-kurtis/p/2qthhh,₹619,24,16,5,3,5,53
136,https://images.meesho.com/images/products/63385044/kngux_400.webp,https://www.meesho.com/chitrarekha-fabulous-kurtis/p/11qk7o,₹440,221,103,89,39,86,538
137,https://images.meesho.com/images/products/159876690/p2cja_400.webp,https://www.meesho.com/abhisarika-voguish-kurtis/p/2n6pn6,₹560,28,12,6,6,15,67
138,https://images.meesho.com/images/products/13625619/56ebc_400.webp,https://www.meesho.com/women-georgette-straight-chikankari-yellow-kurti/p/841lf,₹301,63,22,12,9,21,127
139,https://images.meesho.com/images/products/180600523/fnve6_400.webp,https://www.meesho.com/aagam-superior-kurtis/p/2ziw97,₹308,7,2,0,0,1,10
1310,https://images.meesho.com/images/products/26093521/c9662_400.webp,https://www.meesho.com/charvi-fashionable-kurtis/p/fj9w1,₹586,1228,575,347,193,298,2641
1311,https://images.meesho.com/images/products/182082352/qzmd6_400.webp,https://www.meesho.com/chitrarekha-voguish-kurtis/p/30enn4,₹706,6,3,2,0,2,13
1312,https://images.meesho.com/images/products/172660301/tmedm_400.webp,https://www.meesho.com/trendy-attractive-kurtis/p/2uspjh,₹437,39,14,10,10,18,91
1313,https://images.meesho.com/images/products/70276175/igqea_400.webp,https://www.meesho.com/banita-alluring-kurtis/p/15u9fz,₹430,54,12,18,8,15,107
1314,https://images.meesho.com/images/products/60947947/iiali_400.webp,https://www.meesho.com/jivika-alluring-kurtis/p/10abqj,₹535,347,130,75,56,76,684
1315,https://images.meesho.com/images/products/157639915/wjoxk_400.webp,https://www.meesho.com/aakarsha-sensational-kurtis/p/2lurqj,₹317,4,2,1,1,2,10
1316,https://images.meesho.com/images/products/174929915/h5wip_400.webp,https://www.meesho.com/alisha-drishya-kurtis/p/2w5csb,₹515,29,9,11,1,2,52
1317,https://images.meesho.com/images/products/70245596/eoxxa_400.webp,https://www.meesho.com/chitrarekha-pretty-kurtis/p/15tluk,₹425,24,6,14,3,10,57
1318,https://images.meesho.com/images/products/123308553/kfvgx_400.webp,https://www.meesho.com/festive-special-myra-graceful-kurtis/p/21exhl,₹579,395,136,77,45,69,722
1319,https://images.meesho.com/images/products/108023979/nmazi_400.webp,https://www.meesho.com/chitrarekha-fashionable-kurtis/p/1sbbu3,₹503,112,48,23,15,24,222
1320,https://images.meesho.com/images/products/151452601/81mnz_400.webp,https://www.meesho.com/charvi-graceful-kurtis/p/2i65kp,₹621,14,3,2,3,1,23
141,https://images.meesho.com/images/products/144219234/2qm2l_400.webp,https://www.meesho.com/abhisarika-pretty-kurtis/p/2dv49u,₹291,17,8,6,3,5,39
142,https://images.meesho.com/images/products/77076166/47fnx_400.webp,https://www.meesho.com/charvi-refined-kurtis/p/19w0cm,₹611,63,30,16,8,26,143
143,https://images.meesho.com/images/products/77943845/3nmqc_400.webp,https://www.meesho.com/aagyeyi-alluring-kurtis/p/1aelut,₹368,30,25,7,5,14,81
144,https://images.meesho.com/images/products/18568418/b2be0_400.webp,https://www.meesho.com/women-chiffon-anarkali-chikankari-mustard-kurti/p/b1zhe,₹738,0,0,0,0,0,0
145,https://images.meesho.com/images/products/67182805/txkhg_400.webp,https://www.meesho.com/aishani-attractive-kurtis/p/13zyl1,₹288,747,396,279,195,375,1992
146,https://images.meesho.com/images/products/161432807/q9chm_400.webp,https://www.meesho.com/aagam-graceful-kurtis/p/2o42cn,₹536,34,25,13,8,17,97
147,https://images.meesho.com/images/products/140559279/fktbi_400.webp,https://www.meesho.com/charvi-drishya-kurtis/p/2boo8f,₹471,30,6,2,4,6,48
148,https://images.meesho.com/images/products/92744729/d9zau_400.webp,https://www.meesho.com/aakarsha-sensational-kurtis/p/1j7uah,₹452,84,28,22,17,43,194
149,https://images.meesho.com/images/products/181478571/3nql5_400.webp,https://www.meesho.com/adrika-superior-kurtis/p/301prf,₹436,18,4,3,2,9,36
1410,https://images.meesho.com/images/products/135793215/hwjhk_400.webp,https://www.meesho.com/aishani-petite-kurtis/p/28uipr,₹464,47,18,11,3,6,85
1411,https://images.meesho.com/images/products/77514269/in7t5_400.webp,https://www.meesho.com/trendy-fashionable-kurtis/p/1a5ee5,₹478,144,53,34,28,52,311
1412,https://images.meesho.com/images/products/187682033/xsjlt_400.webp,https://www.meesho.com/adrika-pretty-kurtis/p/33qodt,₹515,0,0,0,0,0,0
1413,https://images.meesho.com/images/products/47173848/elkha_400.webp,https://www.meesho.com/myra-pretty-kurtis/p/s33ko,₹514,79,33,27,13,37,189
1414,https://images.meesho.com/images/products/26000633/9818a_400.webp,https://www.meesho.com/aagyeyi-refined-kurtis/p/fha7t,₹509,144,48,28,24,51,295
1415,https://images.meesho.com/images/products/150309547/daarp_400.webp,https://www.meesho.com/trendy-alluring-kurtis/p/2hhnl7,₹670,35,8,5,3,2,53
1416,https://images.meesho.com/images/products/197338869/qlnsw_400.webp,https://www.meesho.com/trendy-drishya-kurtis/p/39hnn9,₹332,46,14,22,3,22,107
1417,https://images.meesho.com/images/products/172458529/af3fe_400.webp,https://www.meesho.com/abhisarika-petite-kurtis/p/2uodup,₹490,18,8,1,3,8,38
1418,https://images.meesho.com/images/products/1348883/1_400.webp,https://www.meesho.com/womens-embroidered-georgette-kurtis/p/swsz,₹386,50,22,12,9,11,104
1419,https://images.meesho.com/images/products/173259585/bgwtp_400.webp,https://www.meesho.com/aagyeyi-refined-kurtis/p/2v5jy9,₹541,29,9,4,4,13,59
1420,https://images.meesho.com/images/products/51794804/w3esx_400.webp,https://www.meesho.com/trendy-refined-kurtis/p/uu54k,₹407,25,6,4,2,3,40
151,https://images.meesho.com/images/products/183022250/vlird_400.webp,https://www.meesho.com/abhisarika-sensational-kurtis/p/30ysve,₹528,19,4,4,4,7,38
152,https://images.meesho.com/images/products/176676192/yyubt_400.webp,https://www.meesho.com/banita-fabulous-kurtis/p/2x6s80,₹633,14,7,2,4,2,29
153,https://images.meesho.com/images/products/147341646/rf5hl_400.webp,https://www.meesho.com/myra-graceful-kurtis/p/2fq1ji,₹575,4,3,0,1,4,12
154,https://images.meesho.com/images/products/28604006/04569_400.webp,https://www.meesho.com/aagam-drishya-kurtis/p/h12zq,₹334,296,169,111,58,72,706
155,https://images.meesho.com/images/products/193603479/rxr0q_400.webp,https://www.meesho.com/banita-petite-kurtis/p/379lef,₹497,16,10,5,2,10,43
156,https://images.meesho.com/images/products/176766779/2odfs_400.webp,https://www.meesho.com/aakarsha-sensational-kurtis/p/2x8q4b,₹690,28,8,7,6,9,58
157,https://images.meesho.com/images/products/158251132/jtg0r_400.webp,https://www.meesho.com/aagam-drishya-kurtis/p/2m7vcs,₹565,35,9,6,3,9,62
158,https://images.meesho.com/images/products/171447357/uu93w_400.webp,https://www.meesho.com/kashvi-graceful-kurtis/p/2u2pml,₹296,3,0,0,1,0,4
159,https://images.meesho.com/images/products/48970174/kbvas_400.webp,https://www.meesho.com/charvi-petite-kurtis/p/t5lmm,₹588,403,197,123,61,158,942
1510,https://images.meesho.com/images/products/115607906/qedrj_400.webp,https://www.meesho.com/kashvi-drishya-kurtis/p/1wtvmq,₹291,193,96,81,48,118,536
1511,https://images.meesho.com/images/products/108027761/cyyin_400.webp,https://www.meesho.com/aishani-superior-kurtis/p/1sber5,₹512,187,57,37,20,71,372
1512,https://images.meesho.com/images/products/82222448/xdxle_400.webp,https://www.meesho.com/myra-sensational-kurtis/p/1cyb8w,₹384,48,22,11,7,15,103
1513,https://images.meesho.com/images/products/7127983/c2452_400.webp,https://www.meesho.com/women-cotton-aline-chikankari-yellow-kurti/p/48rzj,₹621,2946,1410,681,324,558,5919
1514,https://images.meesho.com/images/products/194797593/d9nz4_400.webp,https://www.meesho.com/banita-drishya-kurtis/p/37z6s9,₹556,17,4,4,0,3,28
1515,https://images.meesho.com/images/products/11448593/37342_400.webp,https://www.meesho.com/women-cotton-aline-chikankari-mustard-kurti/p/6tdsh,₹519,190,88,29,18,22,347
1516,https://images.meesho.com/images/products/106076123/69pgh_400.webp,https://www.meesho.com/myra-fashionable-kurtis/p/1r5kuz,₹715,93,32,16,6,9,156
1517,https://images.meesho.com/images/products/67178169/6exsq_400.webp,https://www.meesho.com/myra-refined-kurtis/p/13zv09,₹297,1180,494,469,296,634,3073
1518,https://images.meesho.com/images/products/162569717/yt6x7_400.webp,https://www.meesho.com/kashvi-ensemble-kurtis/p/2osflh,₹414,18,3,3,1,2,27
1519,https://images.meesho.com/images/products/73856459/qyhyd_400.webp,https://www.meesho.com/trendy-drishya-kurtis/p/17z00b,₹526,9,1,3,0,2,15
1520,https://images.meesho.com/images/products/72604781/aqqow_400.webp,https://www.meesho.com/abhisarika-alluring-kurtis/p/17867h,₹317,69,27,18,9,26,149
161,https://images.meesho.com/images/products/181566579/ywbpd_400.webp,https://www.meesho.com/charvi-petite-kurtis/p/303lo3,₹575,63,25,17,6,20,131
162,https://images.meesho.com/images/products/11706549/21718_400.webp,https://www.meesho.com/women-chiffon-straight-chikankari-yellow-kurti/p/6ywtx,₹580,880,357,269,128,309,1943
163,https://images.meesho.com/images/products/65968351/7gxrc_400.webp,https://www.meesho.com/aagyeyi-voguish-kurtis/p/139xi7,₹965,124,28,21,7,20,200
164,https://images.meesho.com/images/products/158160338/fmrfp_400.webp,https://www.meesho.com/aishani-graceful-kurtis/p/2m5xaq,₹345,3,1,0,1,1,6
165,https://images.meesho.com/images/products/143325174/pcujo_400.webp,https://www.meesho.com/trendy-attractive-kurtis/p/2dbyeu,₹299,81,25,24,16,23,169
166,https://images.meesho.com/images/products/186221030/jiooc_400.webp,https://www.meesho.com/aishani-superior-kurtis/p/32vd2e,₹379,0,0,0,0,0,0
167,https://images.meesho.com/images/products/125822799/vftly_400.webp,https://www.meesho.com/aakarsha-sensational-kurtis/p/22wthr,₹381,64,28,22,7,11,132
168,https://images.meesho.com/images/products/67036848/656xm_400.webp,https://www.meesho.com/kashvi-pretty-kurtis/p/13wtyo,₹358,12,6,8,1,2,29
169,https://images.meesho.com/images/products/149841510/cufjt_400.webp,https://www.meesho.com/kashvi-petite-kurtis/p/2h7mg6,₹457,7,0,3,1,2,13
1610,https://images.meesho.com/images/products/164408696/qz1sh_400.webp,https://www.meesho.com/chitrarekha-graceful-kurtis/p/2pvuk8,₹362,31,7,9,2,14,63
1611,https://images.meesho.com/images/products/171211774/skwbh_400.webp,https://www.meesho.com/chitrarekha-drishya-kurtis/p/2txnum,₹524,27,10,8,2,10,57
1612,https://images.meesho.com/images/products/178984430/w4v61_400.webp,https://www.meesho.com/abhisarika-fabulous-kurtis/p/2yk99q,₹362,45,13,19,6,11,94
1613,https://images.meesho.com/images/products/44134215/rwwhr_400.webp,https://www.meesho.com/aishani-fabulous-kurtis/p/q9y6f,₹637,194,85,51,38,70,438
1614,https://images.meesho.com/images/products/173105376/nf5gb_400.webp,https://www.meesho.com/chitrarekha-ensemble-kurtis/p/2v28yo,₹386,24,13,5,1,2,45
1615,https://images.meesho.com/images/products/149163710/yj9as_400.webp,https://www.meesho.com/aakarsha-graceful-kurtis/p/2gt3ge,₹302,26,8,8,10,10,62
1616,https://images.meesho.com/images/products/143923806/ab844_400.webp,https://www.meesho.com/chitrarekha-voguish-kurtis/p/2dosbi,₹479,174,72,60,37,70,413
1617,https://images.meesho.com/images/products/104527706/7njhi_400.webp,https://www.meesho.com/aagam-fabulous-kurtis/p/1q8e3e,₹389,3,2,2,0,3,10
1618,https://images.meesho.com/images/products/154051883/cuko9_400.webp,https://www.meesho.com/aagam-fashionable-kurtis/p/2jpv6z,₹389,54,12,14,4,12,96
1619,https://images.meesho.com/images/products/108540002/c1txg_400.webp,https://www.meesho.com/festive-special-aagam-pretty-kurtis/p/1sme02,₹579,1336,509,256,154,228,2483
1620,https://images.meesho.com/images/products/131451567/mtpvh_400.webp,https://www.meesho.com/kashvi-ensemble-kurtis/p/269gof,₹362,74,33,16,7,14,144
171,https://images.meesho.com/images/products/147867137/ctoou_400.webp,https://www.meesho.com/alisha-petite-kurtis/p/2g1b0h,₹488,34,15,8,6,7,70
172,https://images.meesho.com/images/products/165264481/pyfsb_400.webp,https://www.meesho.com/banita-ensemble-kurtis/p/2qe6w1,₹454,6,1,2,0,1,10
173,https://images.meesho.com/images/products/11996566/ddkns_400.webp,https://www.meesho.com/womens-rayon-chikankari-short-kurti-kurtis/p/754ly,₹464,299,128,61,34,61,583
174,https://images.meesho.com/images/products/75679985/rs50b_400.webp,https://www.meesho.com/adrika-pretty-kurtis/p/19231t,₹426,159,83,57,44,52,395
175,https://images.meesho.com/images/products/57900889/zm0ak_400.webp,https://www.meesho.com/chitrarekha-attractive-kurtis/p/yh0m1,₹507,685,275,137,79,190,1366
176,https://images.meesho.com/images/products/82309909/kbqmd_400.webp,https://www.meesho.com/trendy-petite-kurtis/p/1d06qd,₹513,78,35,20,8,30,171
177,https://images.meesho.com/images/products/75924145/fxpsi_400.webp,https://www.meesho.com/banita-superior-kurtis/p/197bg1,₹527,52,13,10,5,15,95
178,https://images.meesho.com/images/products/63044447/c2h48_400.webp,https://www.meesho.com/aagam-attractive-kurtis/p/11j9en,₹502,110,39,33,17,60,259
179,https://images.meesho.com/images/products/53799833/gu5gh_400.webp,https://www.meesho.com/myra-refined-kurtis/p/w147t,₹570,772,386,191,98,228,1675
1710,https://images.meesho.com/images/products/165218410/fev1y_400.webp,https://www.meesho.com/jivika-petite-kurtis/p/2qd7ca,₹715,50,21,8,4,15,98
1711,https://images.meesho.com/images/products/186921915/9eosg_400.webp,https://www.meesho.com/banita-superior-kurtis/p/33advf,₹498,7,2,1,0,2,12
1712,https://images.meesho.com/images/products/18726329/0a99b_400.webp,https://www.meesho.com/women-khadi-cotton-aline-chikankari-orange-kurti/p/b5dbt,₹326,10,4,1,2,4,21
1713,https://images.meesho.com/images/products/135793165/k0sbv_400.webp,https://www.meesho.com/aagyeyi-alluring-kurtis/p/28uiod,₹467,178,73,45,17,55,368
1714,https://images.meesho.com/images/products/19499925/60701_400.webp,https://www.meesho.com/women-chiffon-straight-chikankari-yellow-kurti/p/bly8l,₹566,814,392,173,114,196,1689
1715,https://images.meesho.com/images/products/182082910/by0tg_400.webp,https://www.meesho.com/myra-attractive-kurtis/p/30eo2m,₹591,0,0,0,0,0,0
1716,https://images.meesho.com/images/products/135281914/asm4j_400.webp,https://www.meesho.com/chitrarekha-petite-kurtis/p/28jk6y,₹394,300,132,61,31,60,584
1717,https://images.meesho.com/images/products/141117797/xhzar_400.webp,https://www.meesho.com/myra-refined-kurtis/p/2c0n6t,₹530,109,46,39,20,40,254
1718,https://images.meesho.com/images/products/27279673/5321c_400.webp,https://www.meesho.com/chitrarekha-pretty-kurtis/p/g8p4p,₹865,305,106,38,24,25,498
1719,https://images.meesho.com/images/products/100126832/tqixj_400.webp,https://www.meesho.com/aishani-attractive-kurtis/p/1nm2cw,₹499,5,1,3,0,0,9
1720,https://images.meesho.com/images/products/59127353/gkhes_400.webp,https://www.meesho.com/aakarsha-fashionable-kurtis/p/z7ayh,₹581,27,4,16,4,11,62
181,https://images.meesho.com/images/products/145382731/bunbt_400.webp,https://www.meesho.com/abhisarika-drishya-kurtis/p/2ek217,₹523,96,42,36,18,46,238
182,https://images.meesho.com/images/products/9279621/1cd36_400.webp,https://www.meesho.com/attractive-womens-kurti/p/5iw79,₹431,1,5,1,2,0,9
183,https://images.meesho.com/images/products/73311361/boxmz_400.webp,https://www.meesho.com/chitrarekha-sensational-kurtis/p/17nbep,₹499,231,110,58,35,80,514
184,https://images.meesho.com/images/products/170512117/nw89i_400.webp,https://www.meesho.com/aakarsha-superior-kurtis/p/2tinzp,₹596,27,12,11,3,14,67
185,https://images.meesho.com/images/products/57419886/xpd9p_400.webp,https://www.meesho.com/aagyeyi-drishya-kurtis/p/y6pgu,₹593,371,179,96,49,74,769
186,https://images.meesho.com/images/products/175530082/mookm_400.webp,https://www.meesho.com/charvi-pretty-kurtis/p/2wi7vm,₹468,0,0,0,0,0,0
187,https://images.meesho.com/images/products/195855910/0cujv_400.webp,https://www.meesho.com/trendy-graceful-kurtis/p/38lvdy,₹637,4,0,0,0,0,4
188,https://images.meesho.com/images/products/68244496/axt0r_400.webp,https://www.meesho.com/aishani-pretty-kurtis/p/14mpsg,₹425,150,48,44,24,48,314
189,https://images.meesho.com/images/products/70719414/cwquc_400.webp,https://www.meesho.com/kashvi-voguish-kurtis/p/163rg6,₹488,11,4,1,0,6,22
1810,https://images.meesho.com/images/products/60491847/yaedm_400.webp,https://www.meesho.com/alisha-attractive-cotton-kurtis/p/100jt3,₹288,592,241,212,174,309,1528
1811,https://images.meesho.com/images/products/150671161/x933p_400.webp,https://www.meesho.com/adrika-superior-kurtis/p/2hpem1,₹321,41,32,12,13,19,117
1812,https://images.meesho.com/images/products/191714935/34tkz_400.webp,https://www.meesho.com/adrika-petite-kurtis/p/36546v,₹681,33,11,8,2,18,72
1813,https://images.meesho.com/images/products/130013518/wxlra_400.webp,https://www.meesho.com/trendy-petite-kurtis/p/25en2m,₹636,26,13,6,10,10,65
1814,https://images.meesho.com/images/products/150966356/n3mmv_400.webp,https://www.meesho.com/banita-pretty-kurtis/p/2hvqdw,₹321,3,0,4,0,3,10
1815,https://images.meesho.com/images/products/49461565/qckza_400.webp,https://www.meesho.com/adrika-alluring-kurtis/p/tg4sd,₹396,67,26,17,6,19,135
1816,https://images.meesho.com/images/products/155261588/vopbb_400.webp,https://www.meesho.com/abhisarika-attractive-kurtis/p/2kfslw,₹464,86,34,12,9,28,169
1817,https://images.meesho.com/images/products/149843123/lywli_400.webp,https://www.meesho.com/aagyeyi-drishya-kurtis/p/2h7noz,₹461,35,10,12,2,6,65
1818,https://images.meesho.com/images/products/139364278/en9jz_400.webp,https://www.meesho.com/aakarsha-sensational-kurtis/p/2az25y,₹420,90,29,23,12,24,178
1819,https://images.meesho.com/images/products/16470427/syrfz_400.webp,https://www.meesho.com/trendy-drishya-kurtis/p/9t0nv,₹671,12,6,4,2,6,30
1820,https://images.meesho.com/images/products/83533269/nhtnv_400.webp,https://www.meesho.com/trendy-ensemble-kurtis/p/1dqeol,₹577,47,14,11,8,15,95
191,https://images.meesho.com/images/products/54340561/rdaz0_400.webp,https://www.meesho.com/charvi-voguish-kurtis/p/wcpg1,₹353,6,2,5,0,1,14
192,https://images.meesho.com/images/products/29072551/bsh9z_400.webp,https://www.meesho.com/abhisarika-sensational-kurtis/p/hb4iv,₹569,635,311,163,100,191,1400
193,https://images.meesho.com/images/products/145386745/9cshh_400.webp,https://www.meesho.com/aishani-petite-kurtis/p/2ek54p,₹531,5,1,0,0,2,8
194,https://images.meesho.com/images/products/197477012/ay1da_400.webp,https://www.meesho.com/myra-fashionable-kurtis/p/39km8k,₹915,4,1,0,1,0,6
195,https://images.meesho.com/images/products/63649136/apmot_400.webp,https://www.meesho.com/chitrarekha-fabulous-kurtis/p/11w7zk,₹312,361,166,126,62,103,818
196,https://images.meesho.com/images/products/50321352/ztqzl_400.webp,https://www.meesho.com/aakarsha-sensational-kurtis/p/tyk7c,₹647,73,35,24,10,23,165
197,https://images.meesho.com/images/products/73313720/tsedu_400.webp,https://www.meesho.com/adrika-refined-kurtis/p/17nd88,₹486,68,24,22,10,23,147
198,https://images.meesho.com/images/products/145034114/xwbqy_400.webp,https://www.meesho.com/aakarsha-petite-kurtis/p/2ecl1e,₹444,6,2,2,1,1,12
199,https://images.meesho.com/images/products/143954038/3ebll_400.webp,https://www.meesho.com/aishani-superior-kurtis/p/2dpfna,₹525,0,0,0,0,0,0
1910,https://images.meesho.com/images/products/41570059/xv46n_400.webp,https://www.meesho.com/trendy-sensational-kurtis/p/oqznv,₹397,12,4,9,3,6,34
1911,https://images.meesho.com/images/products/58294170/9b7t1_400.webp,https://www.meesho.com/chitrarekha-graceful-kurtis/p/ypg2i,₹595,288,140,92,51,129,700
1912,https://images.meesho.com/images/products/164407661/mbpic_400.webp,https://www.meesho.com/aakarsha-attractive-kurtis/p/2pvtrh,₹338,2,2,1,0,1,6
1913,https://images.meesho.com/images/products/165772642/nfvcs_400.webp,https://www.meesho.com/trendy-petite-kurtis/p/2qp2zm,₹412,10,7,2,3,2,24
1914,https://images.meesho.com/images/products/61472361/a3rhs_400.webp,https://www.meesho.com/chitrarekha-graceful-kurtis/p/10lkdl,₹488,608,257,141,113,237,1356
1915,https://images.meesho.com/images/products/155235738/twc7x_400.webp,https://www.meesho.com/kashvi-fashionable-kurtis/p/2kf8nu,₹440,27,12,10,1,11,61
1916,https://images.meesho.com/images/products/4684198/1_400.webp,https://www.meesho.com/women-cotton-aline-embroidered-yellow-kurti/p/2secm,₹380,15,6,5,3,1,30
1917,https://images.meesho.com/images/products/161788738/jbazn_400.webp,https://www.meesho.com/jivika-refined-kurtis/p/2obozm,₹526,7,1,0,0,0,8
1918,https://images.meesho.com/images/products/178309110/qcrn9_400.webp,https://www.meesho.com/adrika-petite-kurtis/p/2y5s6u,₹636,7,3,3,1,1,15
1919,https://images.meesho.com/images/products/187666353/ee5mw_400.webp,https://www.meesho.com/adrika-alluring-kurtis/p/33qca9,₹351,7,0,2,2,1,12
1920,https://images.meesho.com/images/products/44168437/nwnxt_400.webp,https://www.meesho.com/trendy-fabulous-kurtis/p/qaol1,₹588,63,19,15,6,17,120
201,https://images.meesho.com/images/products/75923772/9ulzc_400.webp,https://www.meesho.com/trendy-fashionable-kurtis/p/197b5o,₹715,105,33,19,8,14,179
202,https://images.meesho.com/images/products/143506238/afpxp_400.webp,https://www.meesho.com/chitrarekha-graceful-kurtis/p/2dfu4e,₹494,23,9,6,1,4,43
203,https://images.meesho.com/images/products/156875925/ubvym_400.webp,https://www.meesho.com/abhisarika-alluring-kurtis/p/2lee8l,₹515,14,14,10,3,12,53
204,https://images.meesho.com/images/products/154121519/umbdi_400.webp,https://www.meesho.com/banita-superior-kurtis/p/2jrcxb,₹760,78,22,22,12,21,155
205,https://images.meesho.com/images/products/185922575/53s37_400.webp,https://www.meesho.com/charvi-attractive-kurtis/p/32oyrz,₹665,10,0,2,0,0,12
206,https://images.meesho.com/images/products/146022412/vd0m8_400.webp,https://www.meesho.com/aakarsha-refined-kurtis/p/2exrm4,₹699,85,24,17,11,15,152
207,https://images.meesho.com/images/products/79295193/tk3p7_400.webp,https://www.meesho.com/aishani-attractive-kurtis/p/1b7kk9,₹271,58,19,16,4,18,115
208,https://images.meesho.com/images/products/70245399/qpehn_400.webp,https://www.meesho.com/banita-voguish-kurtis/p/15tlp3,₹328,0,0,0,0,0,0
209,https://images.meesho.com/images/products/67080042/8kdxw_400.webp,https://www.meesho.com/banita-attractive-kurtis/p/13xrai,₹657,19,11,3,0,3,36
2010,https://images.meesho.com/images/products/146200304/gdw11_400.webp,https://www.meesho.com/kashvi-petite-kurtis/p/2f1kvk,₹487,43,17,17,4,6,87
2011,https://images.meesho.com/images/products/145654223/lkc5e_400.webp,https://www.meesho.com/aagam-refined-kurtis/p/2epvin,₹333,4,2,4,1,0,11
2012,https://images.meesho.com/images/products/145485884/zrczp_400.webp,https://www.meesho.com/myra-petite-kurtis/p/2em9mk,₹440,11,3,0,0,7,21
2013,https://images.meesho.com/images/products/174925257/hfdrm_400.webp,https://www.meesho.com/aagyeyi-attractive-kurtis/p/2w596x,₹591,16,12,6,4,8,46
2014,https://images.meesho.com/images/products/57646822/uviis_400.webp,https://www.meesho.com/aagam-graceful-kurtis/p/ybkkm,₹477,94,33,32,17,43,219
2015,https://images.meesho.com/images/products/156345572/qxuu4_400.webp,https://www.meesho.com/aagam-ensemble-kurtis/p/2l310k,₹374,32,13,13,3,13,74
2016,https://images.meesho.com/images/products/116745343/129ea_400.webp,https://www.meesho.com/myra-ensemble-kurtis/p/1xi9a7,₹291,111,45,47,22,63,288
2017,https://images.meesho.com/images/products/141707827/oqmww_400.webp,https://www.meesho.com/aagyeyi-superior-kurtis/p/2cdagj,₹601,28,10,6,4,8,56
2018,https://images.meesho.com/images/products/197656316/phn1f_400.webp,https://www.meesho.com/abhisarika-voguish-kurtis/p/39ogl8,₹436,0,0,0,0,0,0
2019,https://images.meesho.com/images/products/169006870/jnm1g_400.webp,https://www.meesho.com/charvi-alluring-kurtis/p/2smeja,₹604,0,0,0,0,0,0
2020,https://images.meesho.com/images/products/144509978/ikcx1_400.webp,https://www.meesho.com/myra-superior-kurtis/p/2e1cm2,₹458,31,13,10,7,15,76
211,https://images.meesho.com/images/products/126597008/gppee_400.webp,https://www.meesho.com/charvi-fabulous-kurtis/p/23devk,₹664,103,51,31,27,48,260
212,https://images.meesho.com/images/products/25787232/ac0c9_400.webp,https://www.meesho.com/zola-georgette-ethinic-wear-lucknowi-chikankari-kurta-for-women/p/fcpk0,"₹1,165",203,60,32,7,28,330
213,https://images.meesho.com/images/products/144001702/fd1xo_400.webp,https://www.meesho.com/charvi-superior-kurtis/p/2dqgfa,₹518,301,106,98,57,143,705
214,https://images.meesho.com/images/products/80324001/vodm5_400.webp,https://www.meesho.com/jivika-petite-kurtis/p/1btme9,₹353,0,0,0,0,0,0
215,https://images.meesho.com/images/products/59439853/iybox_400.webp,https://www.meesho.com/aishani-ensemble-kurtis/p/ze031,"₹1,016",108,39,22,14,23,206
216,https://images.meesho.com/images/products/50320861/qdsz3_400.webp,https://www.meesho.com/jivika-alluring-kurtis/p/tyjtp,₹428,211,70,50,30,76,437
217,https://images.meesho.com/images/products/11581687/0e85e_400.webp,https://www.meesho.com/chitrarekha-graceful-kurtis/p/6w8hj,₹580,3207,1428,801,433,861,6730
218,https://images.meesho.com/images/products/73642897/aqsed_400.webp,https://www.meesho.com/adrika-fashionable-kurtis/p/17uf81,₹496,46,16,4,3,8,77
219,https://images.meesho.com/images/products/37300252/e3otp_400.webp,https://www.meesho.com/aishani-drishya-kurtis/p/m7h24,₹323,3,1,1,1,0,6
2110,https://images.meesho.com/images/products/188231478/7vuxd_400.webp,https://www.meesho.com/kashvi-attractive-kurtis/p/342gc6,₹380,0,0,0,0,0,0
2111,https://images.meesho.com/images/products/140591701/g6o0t_400.webp,https://www.meesho.com/chitrarekha-sensational-kurtis/p/2bpd91,₹532,145,49,36,24,69,323
2112,https://images.meesho.com/images/products/143739955/2nxvd_400.webp,https://www.meesho.com/abhisarika-petite-kurtis/p/2dkugj,₹305,13,12,4,2,7,38
2113,https://images.meesho.com/images/products/40199459/mlnpn_400.webp,https://www.meesho.com/trendy-refined-kurtis/p/nxm3n,₹317,231,111,86,70,121,619
2114,https://images.meesho.com/images/products/157959875/fedkx_400.webp,https://www.meesho.com/myra-drishya-kurtis/p/2m1mmb,₹505,23,9,14,10,1,57
2115,https://images.meesho.com/images/products/80135591/iclou_400.webp,https://www.meesho.com/aagam-fashionable-kurtis/p/1bpl0n,₹596,155,70,46,30,59,360
2116,https://images.meesho.com/images/products/103287766/i00qx_400.webp,https://www.meesho.com/chitrarekha-sensational-kurtis/p/1phtcm,₹477,75,29,18,8,23,153
2117,https://images.meesho.com/images/products/135862371/jvbvw_400.webp,https://www.meesho.com/aishani-petite-kurtis/p/28w02r,₹501,91,34,16,10,21,172
2118,https://images.meesho.com/images/products/183033004/76rlc_400.webp,https://www.meesho.com/aakarsha-petite-kurtis/p/30z164,₹440,37,15,13,3,25,93
2119,https://images.meesho.com/images/products/17278885/f795f_400.webp,https://www.meesho.com/kashvi-fashionable-kurtis/p/aach1,₹503,228,93,48,22,66,457
2120,https://images.meesho.com/images/products/182065318/vu3fx_400.webp,https://www.meesho.com/jivika-petite-kurtis/p/30eahy,₹562,28,8,6,4,9,55
221,https://images.meesho.com/images/products/179234973/pwccy_400.webp,https://www.meesho.com/jivika-sensational-kurtis/p/2ypml9,₹611,3,0,0,0,1,4
222,https://images.meesho.com/images/products/55727964/x4x5j_400.webp,https://www.meesho.com/kashvi-attractive-kurtis/p/x6fz0,₹545,27,15,8,7,3,60
223,https://images.meesho.com/images/products/154827181/yomqb_400.webp,https://www.meesho.com/aagam-sensational-kurtis/p/2k6hf1,₹464,98,44,34,20,36,232
224,https://images.meesho.com/images/products/99380539/x8qjh_400.webp,https://www.meesho.com/festive-special-charvi-superior-kurtis/p/1n62ij,₹463,321,133,66,28,42,590
225,https://images.meesho.com/images/products/173680525/bbpop_400.webp,https://www.meesho.com/trendy-refined-kurtis/p/2vekr1,₹297,6,5,3,3,3,20
226,https://images.meesho.com/images/products/192341899/12vtr_400.webp,https://www.meesho.com/charvi-petite-kurtis/p/36ijyj,₹471,18,10,7,3,9,47
227,https://images.meesho.com/images/products/119875194/kd06x_400.webp,https://www.meesho.com/chitrarekha-drishya-kurtis/p/1zdcai,"₹1,467",269,75,47,42,113,546
228,https://images.meesho.com/images/products/62421948/wbg8r_400.webp,https://www.meesho.com/festive-special-charvi-voguish-kurtis/p/115x30,₹529,181,87,61,40,83,452
229,https://images.meesho.com/images/products/156611009/8qk9n_400.webp,https://www.meesho.com/banita-ensemble-kurtis/p/2l8ptt,₹248,11,3,2,3,0,19
2210,https://images.meesho.com/images/products/62581992/0ftl2_400.webp,https://www.meesho.com/abhisarika-ensemble-kurtis/p/119cko,₹293,85,35,37,23,37,217
2211,https://images.meesho.com/images/products/19939755/06843_400.webp,https://www.meesho.com/women-cotton-cambric-aline-chikankari-yellow-kurti/p/bvdm3,₹621,298,141,70,49,80,638
2212,https://images.meesho.com/images/products/88174392/lec2h_400.webp,https://www.meesho.com/adrika-drishya-kurtis/p/1ghvso,₹312,9,2,2,1,2,16
2213,https://images.meesho.com/images/products/160097753/vczu5_400.webp,https://www.meesho.com/abhisarika-petite-kurtis/p/2nbg7t,₹414,11,3,0,2,5,21
2214,https://images.meesho.com/images/products/131012471/qq3le_400.webp,https://www.meesho.com/aagam-voguish-kurtis/p/2601vb,₹416,20,6,6,2,4,38
2215,https://images.meesho.com/images/products/53791607/2boba_400.webp,https://www.meesho.com/myra-sensational-kurtis/p/w0xvb,₹615,39,16,8,4,7,74
2216,https://images.meesho.com/images/products/142609032/ot0hl_400.webp,https://www.meesho.com/aakarsha-pretty-kurtis/p/2cwlu0,₹513,0,0,0,0,0,0
2217,https://images.meesho.com/images/products/74702613/n2ax5_400.webp,https://www.meesho.com/aagam-sensational-kurtis/p/18h4wl,₹295,280,112,111,72,126,701
2218,https://images.meesho.com/images/products/93220313/lvwtb_400.webp,https://www.meesho.com/myra-ensemble-kurtis/p/1ji195,₹343,70,28,32,18,29,177
2219,https://images.meesho.com/images/products/128803056/nfx3n_400.webp,https://www.meesho.com/aagyeyi-graceful-kurtis/p/24op2o,₹273,34,13,17,2,13,79
2220,https://images.meesho.com/images/products/128829611/nfodb_400.webp,https://www.meesho.com/kashvi-graceful-kurtis/p/24p9kb,₹303,120,52,44,29,45,290
231,https://images.meesho.com/images/products/169461813/qgwen_400.webp,https://www.meesho.com/aakarsha-voguish-kurtis/p/2sw5kl,₹291,9,2,1,0,5,17
232,https://images.meesho.com/images/products/67633462/dnlhe_400.webp,https://www.meesho.com/myra-refined-kurtis/p/149mba,₹421,43,7,8,8,14,80
233,https://images.meesho.com/images/products/19568800/307ed_400.webp,https://www.meesho.com/women-cotton-yellow-kurti/p/bnfds,₹487,14,10,3,2,3,32
234,https://images.meesho.com/images/products/183070013/ve5og_400.webp,https://www.meesho.com/charvi-refined-kurtis/p/30ztq5,₹524,35,11,14,4,18,82
235,https://images.meesho.com/images/products/103813907/b4k6h_400.webp,https://www.meesho.com/abhisarika-voguish-kurtis/p/1pt3bn,₹519,6,1,0,1,0,8
236,https://images.meesho.com/images/products/158861458/t6rst_400.webp,https://www.meesho.com/aagam-attractive-kurtis/p/2mkyaa,₹316,0,0,0,0,0,0
237,https://images.meesho.com/images/products/54661027/qfk10_400.webp,https://www.meesho.com/trendy-ensemble-kurtis/p/wjkpv,₹579,59,13,13,5,22,112
238,https://images.meesho.com/images/products/85855416/fxfml_400.webp,https://www.meesho.com/abhisarika-superior-kurtis/p/1f46go,₹489,18,5,5,4,13,45
239,https://images.meesho.com/images/products/172732948/n8rij_400.webp,https://www.meesho.com/kashvi-drishya-kurtis/p/2uu9lg,₹491,0,0,0,0,0,0
2310,https://images.meesho.com/images/products/185964689/v8q0n_400.webp,https://www.meesho.com/jivika-pretty-kurtis/p/32pv9t,₹464,41,26,9,8,11,95
2311,https://images.meesho.com/images/products/64980765/eiyvd_400.webp,https://www.meesho.com/adrika-pretty-kurtis/p/12orh9,₹541,19,12,8,5,6,50
2312,https://images.meesho.com/images/products/160389503/mtqrg_400.webp,https://www.meesho.com/aagyeyi-pretty-kurtis/p/2nhpbz,₹916,32,8,6,3,14,63
2313,https://images.meesho.com/images/products/186050848/hmwxa_400.webp,https://www.meesho.com/abhisarika-graceful-kurtis/p/32rpr4,₹293,12,3,2,1,2,20
2314,https://images.meesho.com/images/products/58522706/gxkdk_400.webp,https://www.meesho.com/aishani-pretty-kurtis/p/yuceq,₹480,27,5,2,3,13,50
2315,https://images.meesho.com/images/products/74711241/lv2e9_400.webp,https://www.meesho.com/trendy-sensational-kurtis/p/18hbk9,₹295,406,155,122,91,207,981
2316,https://images.meesho.com/images/products/195581793/td2jr_400.webp,https://www.meesho.com/myra-attractive-kurtis/p/38fzvl,₹455,0,0,0,0,0,0
2317,https://images.meesho.com/images/products/172543475/9qiea_400.webp,https://www.meesho.com/alisha-graceful-kurtis/p/2uq7eb,₹325,6,1,2,1,0,10
2318,https://images.meesho.com/images/products/119648134/92e87_400.webp,https://www.meesho.com/kashvi-pretty-kurtis/p/1z8h3a,₹322,0,0,0,0,0,0
2319,https://images.meesho.com/images/products/44168425/a0tkp_400.webp,https://www.meesho.com/alisha-voguish-kurtis/p/qaokp,₹581,51,19,11,7,13,101
2320,https://images.meesho.com/images/products/172527562/vwjwr_400.webp,https://www.meesho.com/myra-attractive-kurtis/p/2upv4a,₹399,18,2,4,3,5,32
241,https://images.meesho.com/images/products/59094314/vkbws_400.webp,https://www.meesho.com/adrika-superior-kurtis/p/z6lgq,₹656,140,58,26,28,51,303
242,https://images.meesho.com/images/products/49825709/ipxsi_400.webp,https://www.meesho.com/alisha-ensemble-kurtis/p/tnxrh,₹529,190,72,49,30,71,412
243,https://images.meesho.com/images/products/164003091/wippy_400.webp,https://www.meesho.com/adrika-petite-kurtis/p/2pn5lf,₹347,178,58,37,22,54,349
244,https://images.meesho.com/images/products/159880515/bzznf_400.webp,https://www.meesho.com/banita-voguish-kurtis/p/2n6slf,₹507,0,0,0,0,0,0
245,https://images.meesho.com/images/products/79788679/xcxrw_400.webp,https://www.meesho.com/aishani-voguish-kurtis/p/1bi5c7,₹577,3,0,1,1,2,7
246,https://images.meesho.com/images/products/196684919/rsh1c_400.webp,https://www.meesho.com/aishani-pretty-kurtis/p/393n1z,₹516,29,15,10,2,9,65
247,https://images.meesho.com/images/products/160382548/a5nqj_400.webp,https://www.meesho.com/kashvi-voguish-kurtis/p/2nhjys,₹389,15,4,4,3,6,32
248,https://images.meesho.com/images/products/24931287/f8387_400.webp,https://www.meesho.com/aishani-pretty-kurtis/p/eud3r,₹335,464,164,100,56,66,850
249,https://images.meesho.com/images/products/88748090/ganhy_400.webp,https://www.meesho.com/aagyeyi-attractive-kurtis/p/1gu6gq,₹476,245,103,50,22,40,460
2410,https://images.meesho.com/images/products/137387548/ndix4_400.webp,https://www.meesho.com/chitrarekha-voguish-kurtis/p/29sows,₹556,20,6,2,1,2,31
2411,https://images.meesho.com/images/products/180117320/yyqgs_400.webp,https://www.meesho.com/aishani-pretty-kurtis/p/2z8jew,₹440,5,0,0,1,2,8
2412,https://images.meesho.com/images/products/157054411/irg2l_400.webp,https://www.meesho.com/adrika-voguish-kurtis/p/2li7yj,₹503,175,69,55,46,72,417
2413,https://images.meesho.com/images/products/137307546/xo24u_400.webp,https://www.meesho.com/alisha-superior-kurtis/p/29qz6i,₹742,144,62,37,20,64,327
2414,https://images.meesho.com/images/products/143621912/6cbfv_400.webp,https://www.meesho.com/banita-graceful-kurtis/p/2dibdk,₹286,23,10,7,3,5,48
2415,https://images.meesho.com/images/products/41611613/qvjct_400.webp,https://www.meesho.com/adrika-voguish-kurtis/p/orvq5,"₹1,465",62,17,8,4,1,92
2416,https://images.meesho.com/images/products/146094343/vpfjq_400.webp,https://www.meesho.com/charvi-attractive-kurtis/p/2ezb47,₹476,138,40,34,34,60,306
2417,https://images.meesho.com/images/products/7737685/4be2f_400.webp,https://www.meesho.com/women-rayon-aline-chikankari-yellow-kurti/p/4lufp,₹542,281,113,89,50,135,668
2418,https://images.meesho.com/images/products/117733706/bjsc1_400.webp,https://www.meesho.com/adrika-fabulous-kurtis/p/1y3fwq,₹464,2,3,1,1,0,7
2419,https://images.meesho.com/images/products/160113787/3gwoj_400.webp,https://www.meesho.com/chitrarekha-sensational-kurtis/p/2nbsl7,₹502,15,5,1,1,6,28
2420,https://images.meesho.com/images/products/167281662/hykku_400.webp,https://www.meesho.com/adrika-attractive-kurtis/p/2rlfcu,₹420,8,5,2,1,1,17
251,https://images.meesho.com/images/products/148112892/sr5iq_400.webp,https://www.meesho.com/banita-ensemble-kurtis/p/2g6kn0,₹451,87,33,27,7,21,175
252,https://images.meesho.com/images/products/47896566/nznnk_400.webp,https://www.meesho.com/banita-fabulous-kurtis/p/sil86,₹395,597,248,185,81,148,1259
253,https://images.meesho.com/images/products/174976178/f94dt_400.webp,https://www.meesho.com/alisha-superior-kurtis/p/2w6che,₹409,36,10,13,11,11,81
254,https://images.meesho.com/images/products/58085082/mm7au_400.webp,https://www.meesho.com/banita-superior-kurtis/p/ykyqi,₹586,416,189,107,69,128,909
255,https://images.meesho.com/images/products/193479257/hxi7g_400.webp,https://www.meesho.com/abhisarika-fashionable-kurtis/p/376xjt,₹457,14,6,3,1,1,25
256,https://images.meesho.com/images/products/31662984/44b93_400.webp,https://www.meesho.com/alisha-petite-kurtis/p/iunbc,₹322,149,75,38,6,26,294
257,https://images.meesho.com/images/products/65995462/odr02_400.webp,https://www.meesho.com/chitrarekha-drishya-kurtis/p/13aifa,₹865,92,20,9,4,8,133
258,https://images.meesho.com/images/products/182422654/xpfs5_400.webp,https://www.meesho.com/alisha-superior-kurtis/p/30ly7y,₹441,4,10,5,1,6,26
259,https://images.meesho.com/images/products/154936364/ljdpu_400.webp,https://www.meesho.com/alisha-ensemble-kurtis/p/2k8tnw,₹333,110,37,27,13,34,221
2510,https://images.meesho.com/images/products/68250696/do6wx_400.webp,https://www.meesho.com/aishani-ensemble-kurtis/p/14muko,₹426,72,23,24,16,32,167
2511,https://images.meesho.com/images/products/166886827/ops8r_400.webp,https://www.meesho.com/aishani-petite-kurtis/p/2rcyp7,₹686,15,5,3,2,7,32
2512,https://images.meesho.com/images/products/45451964/z4kjk_400.webp,https://www.meesho.com/aishani-pretty-kurtis/p/r26yk,₹362,13,5,4,0,2,24
2513,https://images.meesho.com/images/products/40978520/1wkll_400.webp,https://www.meesho.com/alisha-voguish-kurtis/p/oeb88,₹394,114,44,40,32,57,287
2514,https://images.meesho.com/images/products/164044876/szkjv_400.webp,https://www.meesho.com/alisha-refined-kurtis/p/2po1u4,₹425,38,13,14,3,12,80
2515,https://images.meesho.com/images/products/192358729/hv11i_400.webp,https://www.meesho.com/aishani-alluring-kurtis/p/36iwy1,₹730,21,5,1,3,3,33
2516,https://images.meesho.com/images/products/74712950/m0j5h_400.webp,https://www.meesho.com/alisha-ensemble-kurtis/p/18hcvq,₹292,49,11,17,6,17,100
2517,https://images.meesho.com/images/products/180620782/tfvng_400.webp,https://www.meesho.com/adrika-pretty-kurtis/p/2zjbvy,₹441,0,0,0,0,0,0
2518,https://images.meesho.com/images/products/24042029/56368_400.webp,https://www.meesho.com/kashvi-voguish-kurtis/p/ebay5,₹335,122,42,33,17,22,236
2519,https://images.meesho.com/images/products/100171776/w6hct_400.webp,https://www.meesho.com/aakarsha-petite-kurtis/p/1nn11c,₹391,29,7,4,3,4,47
2520,https://images.meesho.com/images/products/7731469/137ce_400.webp,https://www.meesho.com/charvi-fashionable-kurtis/p/4lpn1,₹371,81,34,17,9,20,161
261,https://images.meesho.com/images/products/167448272/gh4ze_400.webp,https://www.meesho.com/chitrarekha-superior-kurtis/p/2rozww,₹511,10,4,5,3,3,25
262,https://images.meesho.com/images/products/175276877/u9kdg_400.webp,https://www.meesho.com/alisha-fabulous-kurtis/p/2wcsi5,₹308,4,4,2,1,2,13
263,https://images.meesho.com/images/products/61525768/k369i_400.webp,https://www.meesho.com/kashvi-attractive-kurtis/p/10mpl4,₹778,0,0,0,0,0,0
264,https://images.meesho.com/images/products/77058906/vgrhv_400.webp,https://www.meesho.com/kashvi-pretty-kurtis/p/19vn16,₹596,8,4,2,3,3,20
265,https://images.meesho.com/images/products/55310389/2jqy4_400.webp,https://www.meesho.com/jivika-refined-kurtis/p/wxhrp,₹286,378,82,75,60,72,667
266,https://images.meesho.com/images/products/92749368/ckhog_400.webp,https://www.meesho.com/adrika-superior-kurtis/p/1j7xvc,₹342,282,106,53,29,36,506
267,https://images.meesho.com/images/products/173111323/leed1_400.webp,https://www.meesho.com/abhisarika-voguish-kurtis/p/2v2djv,₹681,55,15,7,8,17,102
268,https://images.meesho.com/images/products/74667999/r9wmy_400.webp,https://www.meesho.com/alisha-pretty-kurtis/p/18ge73,₹290,34,13,8,7,13,75
269,https://images.meesho.com/images/products/156203183/fuqq4_400.webp,https://www.meesho.com/jivika-fashionable-kurtis/p/2kzz5b,₹274,67,24,22,13,27,153
2610,https://images.meesho.com/images/products/72109386/uw1kh_400.webp,https://www.meesho.com/jivika-graceful-kurtis/p/16xjyi,₹527,406,151,127,78,220,982
2611,https://images.meesho.com/images/products/61955052/2zqvo_400.webp,https://www.meesho.com/cotton-ensemble-women-kurtis/p/10vwto,₹617,89,40,26,17,29,201
2612,https://images.meesho.com/images/products/122807790/iiws1_400.webp,https://www.meesho.com/kashvi-ensemble-kurtis/p/21473i,₹534,18,6,2,4,6,36
2613,https://images.meesho.com/images/products/58071750/g0hv5_400.webp,https://www.meesho.com/charvi-fabulous-kurtis/p/ykog6,₹585,60,22,11,11,19,123
2614,https://images.meesho.com/images/products/169209948/krpye_400.webp,https://www.meesho.com/aagyeyi-sensational-kurtis/p/2sqr8c,₹564,69,22,18,10,26,145
2615,https://images.meesho.com/images/products/53792394/krk9p_400.webp,https://www.meesho.com/chitrarekha-attractive-kurtis/p/w0yh6,₹589,36,8,2,1,1,48
2616,https://images.meesho.com/images/products/47558844/jn1j6_400.webp,https://www.meesho.com/alisha-superior-kurtis/p/sbcn0,₹875,60,18,20,12,25,135
2617,https://images.meesho.com/images/products/195215335/ir0si_400.webp,https://www.meesho.com/alisha-petite-kurtis/p/388547,₹449,0,0,0,0,0,0
2618,https://images.meesho.com/images/products/70887647/swbo4_400.webp,https://www.meesho.com/kashvi-alluring-kurtis/p/167d9b,₹429,56,18,17,17,18,126
2619,https://images.meesho.com/images/products/67235840/w2tne_400.webp,https://www.meesho.com/aishani-alluring-kurtis/p/1413i8,₹293,47,25,27,9,18,126
2620,https://images.meesho.com/images/products/153736743/9o7ko_400.webp,https://www.meesho.com/adrika-ensemble-kurtis/p/2jj413,₹342,8,2,3,1,1,15
271,https://images.meesho.com/images/products/160784968/h0hyu_400.webp,https://www.meesho.com/adrika-alluring-kurtis/p/2nq6h4,₹506,7,2,1,0,0,10
272,https://images.meesho.com/images/products/197490961/ts7wi_400.webp,https://www.meesho.com/kashvi-fabulous-kurtis/p/39kx01,₹615,6,1,0,1,0,8
273,https://images.meesho.com/images/products/77502500/zxboo_400.webp,https://www.meesho.com/aagyeyi-refined-kurtis/p/1a55b8,₹543,53,30,20,3,10,116
274,https://images.meesho.com/images/products/112613447/lpz2r_400.webp,https://www.meesho.com/festive-special-kashvi-fabulous-kurtis/p/1v1p3b,₹340,89,27,12,9,15,152
275,https://images.meesho.com/images/products/182368614/sr4rv_400.webp,https://www.meesho.com/myra-drishya-kurtis/p/30ksiu,₹536,2,1,0,0,2,5
276,https://images.meesho.com/images/products/160783501/tfysx_400.webp,https://www.meesho.com/aishani-attractive-kurtis/p/2nq5cd,₹476,57,20,17,1,15,110
277,https://images.meesho.com/images/products/60876459/yxcwz_400.webp,https://www.meesho.com/aakarsha-pretty-kurtis/p/108skr,₹293,189,64,62,36,54,405
278,https://images.meesho.com/images/products/57780776/hzs85_400.webp,https://www.meesho.com/charvi-attractive-kurtis/p/yefxk,₹588,16,11,3,4,9,43
279,https://images.meesho.com/images/products/59140510/rlmye_400.webp,https://www.meesho.com/aishani-fabulous-kurtis/p/z7l3y,₹589,22,10,6,2,1,41
2710,https://images.meesho.com/images/products/182016237/cjb8w_400.webp,https://www.meesho.com/banita-ensemble-kurtis/p/30d8ml,₹490,5,0,1,0,3,9
2711,https://images.meesho.com/images/products/3128153/1_400.webp,https://www.meesho.com/women-cotton-aline-embroidered-mustard-kurti/p/1v1p5,₹366,21,11,7,4,2,45
2712,https://images.meesho.com/images/products/41523747/pexbp_400.webp,https://www.meesho.com/myra-fabulous-kurtis/p/opzxf,₹387,5,1,2,0,6,14
2713,https://images.meesho.com/images/products/182066124/4d9kw_400.webp,https://www.meesho.com/aishani-graceful-kurtis/p/30eb4c,₹586,0,0,0,0,0,0
2714,https://images.meesho.com/images/products/144216593/x4h6s_400.webp,https://www.meesho.com/charvi-alluring-kurtis/p/2dv28h,₹295,0,0,0,0,0,0
2715,https://images.meesho.com/images/products/156541767/lsb4x_400.webp,https://www.meesho.com/charvi-pretty-kurtis/p/2l78ef,₹515,0,0,0,0,0,0
2716,https://images.meesho.com/images/products/171264129/k6yfx_400.webp,https://www.meesho.com/chitrarekha-ensemble-kurtis/p/2tys8x,₹291,0,0,0,0,0,0
2717,https://images.meesho.com/images/products/20733579/62624_400.webp,https://www.meesho.com/attractive-kurtis/p/cce4r,₹581,1107,526,305,157,274,2369
2718,https://images.meesho.com/images/products/42143393/5mqdk_400.webp,https://www.meesho.com/adrika-pretty-kurtis/p/p3a1t,₹489,172,84,32,27,51,366
2719,https://images.meesho.com/images/products/50525128/qvjgq_400.webp,https://www.meesho.com/charvi-superior-kurtis/p/u2xfs,₹535,45,14,16,16,21,112
2720,https://images.meesho.com/images/products/77059242/fhqvp_400.webp,https://www.meesho.com/myra-drishya-kurtis/p/19vnai,₹596,27,14,3,3,11,58
281,https://images.meesho.com/images/products/70603772/9jwuk_400.webp,https://www.meesho.com/jivika-drishya-kurtis/p/161a7w,"₹1,020",23,5,3,3,9,43
282,https://images.meesho.com/images/products/181564987/zsqbi_400.webp,https://www.meesho.com/myra-drishya-kurtis/p/303kfv,₹303,0,0,0,0,0,0
283,https://images.meesho.com/images/products/181031572/yxjvm_400.webp,https://www.meesho.com/myra-drishya-kurtis/p/2zs4us,₹459,0,0,0,0,0,0
284,https://images.meesho.com/images/products/184016684/gvqjp_400.webp,https://www.meesho.com/aakarsha-pretty-kurtis/p/31k46k,₹546,0,0,0,0,0,0
285,https://images.meesho.com/images/products/164383350/sm1pl_400.webp,https://www.meesho.com/aagyeyi-petite-kurtis/p/2pvb06,₹511,0,0,0,0,0,0
286,https://images.meesho.com/images/products/186630541/73jfy_400.webp,https://www.meesho.com/aishani-refined-kurtis/p/33451p,₹363,0,0,0,0,0,0
287,https://images.meesho.com/images/products/62778840/arn4z_400.webp,https://www.meesho.com/aishani-alluring-kurtis/p/11dkgo,₹437,124,51,31,14,53,273
288,https://images.meesho.com/images/products/21244484/33f15_400.webp,https://www.meesho.com/jivika-attractive-kurtis/p/cncck,₹481,240,98,34,20,29,421
289,https://images.meesho.com/images/products/63417708/wphju_400.webp,https://www.meesho.com/festive-special-alisha-attractive-kurtis/p/11r9f0,₹615,9,3,0,0,6,18
2810,https://images.meesho.com/images/products/160351720/c2tv4_400.webp,https://www.meesho.com/abhisarika-drishya-kurtis/p/2ngw6g,₹298,2,2,0,1,1,6
2811,https://images.meesho.com/images/products/159962657/dhyem_400.webp,https://www.meesho.com/jivika-ensemble-kurtis/p/2n8jz5,₹529,11,8,4,0,0,23
2812,https://images.meesho.com/images/products/144445307/tdhu1_400.webp,https://www.meesho.com/myra-refined-kurtis/p/2dzypn,₹576,84,38,32,19,45,218
2813,https://images.meesho.com/images/products/144350067/lyw5i_400.webp,https://www.meesho.com/jivika-refined-kurtis/p/2dxx83,₹306,4,1,1,0,1,7
2814,https://images.meesho.com/images/products/186009594/v1yry_400.webp,https://www.meesho.com/chitrarekha-voguish-kurtis/p/32qtx6,₹646,3,1,1,2,1,8
2815,https://images.meesho.com/images/products/32785427/1dpok_400.webp,https://www.meesho.com/banita-sensational-kurtis/p/jipeb,₹584,102,35,25,14,49,225
2816,https://images.meesho.com/images/products/58930313/cpy2n_400.webp,https://www.meesho.com/abhisarika-fashionable-kurtis/p/z32x5,₹579,1413,504,270,143,271,2601
2817,https://images.meesho.com/images/products/172979401/emthv_400.webp,https://www.meesho.com/myra-attractive-kurtis/p/2uzjrd,₹599,0,0,0,0,0,0
2818,https://images.meesho.com/images/products/156586793/dfdrb_400.webp,https://www.meesho.com/banita-superior-kurtis/p/2l8755,₹515,22,8,9,1,0,40
2819,https://images.meesho.com/images/products/139394825/r445q_400.webp,https://www.meesho.com/aishani-alluring-kurtis/p/2azpqh,₹416,32,13,10,5,14,74
2820,https://images.meesho.com/images/products/30590488/bf767_400.webp,https://www.meesho.com/trendy-kurtis/p/i7nrs,₹865,43,13,14,8,23,101
291,https://images.meesho.com/images/products/55637135/xzu9z_400.webp,https://www.meesho.com/banita-pretty-kurtis/p/x4hvz,₹586,66,26,25,10,17,144
292,https://images.meesho.com/images/products/192905473/7pa7n_400.webp,https://www.meesho.com/alisha-refined-kurtis/p/36umtd,₹448,124,51,23,17,22,237
293,https://images.meesho.com/images/products/185406210/b6qpk_400.webp,https://www.meesho.com/kashvi-sensational-kurtis/p/32dwci,₹295,3,3,5,1,3,15
294,https://images.meesho.com/images/products/50676740/8npyl_400.webp,https://www.meesho.com/aagyeyi-fashionable-kurtis/p/u66f8,₹295,182,81,55,38,47,403
295,https://images.meesho.com/images/products/73306852/puvpv_400.webp,https://www.meesho.com/charvi-ensemble-kurtis/p/17n7xg,₹556,276,126,80,32,72,586
296,https://images.meesho.com/images/products/182421348/n9s72_400.webp,https://www.meesho.com/charvi-pretty-kurtis/p/30lx7o,₹437,0,0,0,0,0,0
297,https://images.meesho.com/images/products/56430281/uquh9_400.webp,https://www.meesho.com/chitrarekha-refined-kurtis/p/xlhvt,₹585,162,57,45,16,62,342
298,https://images.meesho.com/images/products/140550782/sbati_400.webp,https://www.meesho.com/trendy-voguish-kurtis/p/2bohoe,₹536,23,15,4,6,7,55
299,https://images.meesho.com/images/products/45663300/hxzte_400.webp,https://www.meesho.com/kashvi-ensemble-kurtis/p/r6q10,₹415,16,3,3,1,2,25
2910,https://images.meesho.com/images/products/71602863/s4rt2_400.webp,https://www.meesho.com/alisha-superior-kurtis/p/16mp4f,₹826,72,33,18,13,32,168
2911,https://images.meesho.com/images/products/181513732/ww4al_400.webp,https://www.meesho.com/banita-ensemble-kurtis/p/302gw4,₹435,11,7,4,1,6,29
2912,https://images.meesho.com/images/products/121266184/dvsd0_400.webp,https://www.meesho.com/aagam-graceful-kurtis/p/2075l4,₹865,30,4,1,2,1,38
2913,https://images.meesho.com/images/products/144202702/qjuit_400.webp,https://www.meesho.com/aakarsha-attractive-kurtis/p/2durim,₹292,103,45,25,18,43,234
2914,https://images.meesho.com/images/products/159911763/kvhrg_400.webp,https://www.meesho.com/kashvi-graceful-kurtis/p/2n7gpf,₹484,4,2,0,0,0,6
2915,https://images.meesho.com/images/products/156002066/4sga0_400.webp,https://www.meesho.com/aakarsha-fashionable-kurtis/p/2kvnyq,₹716,11,1,2,0,4,18
2916,https://images.meesho.com/images/products/116810609/evp0m_400.webp,https://www.meesho.com/adrika-voguish-kurtis/p/1xjnn5,₹464,17,3,0,1,4,25
2917,https://images.meesho.com/images/products/48696793/foqy5_400.webp,https://www.meesho.com/banita-fashionable-kurtis/p/szqop,₹606,119,54,36,30,37,276
2918,https://images.meesho.com/images/products/177062399/tojal_400.webp,https://www.meesho.com/charvi-petite-kurtis/p/2xf27z,₹716,11,1,1,1,6,20
2919,https://images.meesho.com/images/products/197344556/z0lze_400.webp,https://www.meesho.com/alisha-petite-kurtis/p/39hs18,"₹1,091",17,9,5,4,8,43
2920,https://images.meesho.com/images/products/62813082/kcbtm_400.webp,https://www.meesho.com/banita-fashionable-kurtis/p/11eavu,₹490,47,16,16,9,15,103
301,https://images.meesho.com/images/products/164849376/fmmmo_400.webp,https://www.meesho.com/aishani-refined-kurtis/p/2q5alc,₹434,0,0,0,0,0,0
302,https://images.meesho.com/images/products/117708270/lyxwb_400.webp,https://www.meesho.com/adrika-superior-kurtis/p/1y2wa6,₹287,36,15,7,15,7,80
303,https://images.meesho.com/images/products/146596625/fwgmy_400.webp,https://www.meesho.com/aakarsha-pretty-kurtis/p/2fa2oh,₹444,22,8,5,2,6,43
304,https://images.meesho.com/images/products/166505556/6dodi_400.webp,https://www.meesho.com/charvi-drishya-kurtis/p/2r4sic,₹358,36,11,6,3,13,69
305,https://images.meesho.com/images/products/113149291/vqxdw_400.webp,https://www.meesho.com/festive-special-adrika-drishya-kurtis/p/1vd6jv,₹328,18,8,4,1,11,42
306,https://images.meesho.com/images/products/101766655/y6cvn_400.webp,https://www.meesho.com/alisha-petite-kurtis/p/1ol7nj,₹464,121,53,33,22,69,298
307,https://images.meesho.com/images/products/164794835/8gndx_400.webp,https://www.meesho.com/alisha-petite-kurtis/p/2q44ib,₹561,154,48,30,18,47,297
308,https://images.meesho.com/images/products/181003083/tl8dc_400.webp,https://www.meesho.com/kurtis/p/2zrivf,₹764,6,5,3,2,3,19
309,https://images.meesho.com/images/products/11338408/867a9_400.webp,https://www.meesho.com/women-cotton-aline-chikankari-yellow-kurti/p/6r0rs,₹528,130,64,29,13,10,246
3010,https://images.meesho.com/images/products/116470822/uvgar_400.webp,https://www.meesho.com/kashvi-pretty-kurtis/p/1xcdgm,₹353,28,18,7,2,12,67
3011,https://images.meesho.com/images/products/45655670/fbpgp_400.webp,https://www.meesho.com/abhisarika-drishya-kurtis/p/r6k52,₹580,56,17,18,13,14,118
3012,https://images.meesho.com/images/products/197110245/kbuqo_400.webp,https://www.meesho.com/charvi-alluring-kurtis/p/39cr8l,₹298,48,7,18,11,17,101
3013,https://images.meesho.com/images/products/118135866/bmihv_400.webp,https://www.meesho.com/abhisarika-attractive-kurtis/p/1yc27u,₹453,81,24,15,10,14,144
3014,https://images.meesho.com/images/products/182423977/jawul_400.webp,https://www.meesho.com/trendy-fabulous-kurtis/p/30lz8p,₹437,6,6,3,3,4,22
3015,https://images.meesho.com/images/products/82927876/sbj6x_400.webp,https://www.meesho.com/aakarsha-pretty-kurtis/p/1ddfk4,₹651,120,48,32,23,25,248
3016,https://images.meesho.com/images/products/193845929/oevue_400.webp,https://www.meesho.com/charvi-fashionable-kurtis/p/37esh5,₹592,4,5,1,1,4,15
3017,https://images.meesho.com/images/products/74688194/coovi_400.webp,https://www.meesho.com/trendy-alluring-kurtis/p/18gts2,₹289,33,22,7,4,13,79
3018,https://images.meesho.com/images/products/51820521/j4nxd_400.webp,https://www.meesho.com/chitrarekha-attractive-kurtis/p/uuoyx,₹548,100,45,23,19,30,217
3019,https://images.meesho.com/images/products/179302488/cczma_400.webp,https://www.meesho.com/princess-trendy-girls-kurtis-kurtas/p/2yr2oo,₹620,0,0,0,0,0,0
3020,https://images.meesho.com/images/products/182707688/pvqb3_400.webp,https://www.meesho.com/aakarsha-graceful-kurtis/p/30s25k,₹388,12,0,4,0,6,22
311,https://images.meesho.com/images/products/53842037/yzbv5_400.webp,https://www.meesho.com/adrika-alluring-kurtis/p/w20s5,₹354,49,22,12,11,22,116
312,https://images.meesho.com/images/products/148116623/gohp3_400.webp,https://www.meesho.com/trendy-superior-kurtis/p/2g6nin,₹451,13,2,1,0,2,18
313,https://images.meesho.com/images/products/15252571/b43bb_400.webp,https://www.meesho.com/abhisarika-superior-kurtis/p/92wyj,₹548,49,25,7,7,9,97
314,https://images.meesho.com/images/products/79148507/zhgyd_400.webp,https://www.meesho.com/myra-sensational-kurtis/p/1b4fdn,₹816,3,1,0,0,1,5
315,https://images.meesho.com/images/products/192410073/rknfc_400.webp,https://www.meesho.com/aagam-petite-kurtis/p/36k0k9,₹309,0,0,0,0,0,0
316,https://images.meesho.com/images/products/154313140/hwads_400.webp,https://www.meesho.com/aagam-voguish-kurtis/p/2jvgs4,₹551,7,6,2,0,1,16
317,https://images.meesho.com/images/products/158717462/9cnvb_400.webp,https://www.meesho.com/kashvi-drishya-kurtis/p/2mhv6e,₹405,1,3,0,0,0,4
318,https://images.meesho.com/images/products/166551023/dqytm_400.webp,https://www.meesho.com/trendy-ensemble-kurtis/p/2r5rlb,₹631,0,0,0,0,0,0
319,https://images.meesho.com/images/products/155565468/pdnnk_400.webp,https://www.meesho.com/myra-pretty-kurtis/p/2kmb30,₹666,5,0,0,0,1,6
3110,https://images.meesho.com/images/products/127995143/po658_400.webp,https://www.meesho.com/abhisarika-drishya-kurtis/p/247don,₹355,0,0,0,0,0,0
3111,https://images.meesho.com/images/products/158974949/fzfed_400.webp,https://www.meesho.com/trendy-pretty-kurtis/p/2mndut,₹456,1,2,1,0,0,4
3112,https://images.meesho.com/images/products/174926035/8gkkk_400.webp,https://www.meesho.com/chitrarekha-attractive-kurtis/p/2w59sj,₹594,0,0,0,0,0,0
3113,https://images.meesho.com/images/products/8061491/6df12_400.webp,https://www.meesho.com/women-chiffon-yellow-kurti/p/4ssab,₹947,5,2,1,2,1,11
3114,https://images.meesho.com/images/products/63436035/ruki7_400.webp,https://www.meesho.com/festive-special-kashvi-attractive-kurtis/p/11rnk3,₹622,4,3,1,3,1,12
3115,https://images.meesho.com/images/products/45793771/xcuxq_400.webp,https://www.meesho.com/kashvi-voguish-kurtis/p/r9ip7,₹715,3,0,0,1,1,5
3116,https://images.meesho.com/images/products/125530863/vkftm_400.webp,https://www.meesho.com/aakarsha-sensational-kurtis/p/22qk8f,₹190,17,3,5,6,6,37
3117,https://images.meesho.com/images/products/159585280/ydx3r_400.webp,https://www.meesho.com/aagyeyi-drishya-kurtis/p/2n0gsg,₹315,3,2,0,1,1,7
3118,https://images.meesho.com/images/products/186881120/19qj3_400.webp,https://www.meesho.com/adrika-sensational-kurtis/p/339ie8,₹691,4,0,1,0,1,6
3119,https://images.meesho.com/images/products/83958254/pkacf_400.webp,https://www.meesho.com/kashvi-attractive-kurtis/p/1dzilq,₹596,60,29,13,8,21,131
3120,https://images.meesho.com/images/products/144418782/zmmbr_400.webp,https://www.meesho.com/charvi-voguish-kurtis/p/2dze8u,₹301,2,2,0,2,0,6
321,https://images.meesho.com/images/products/17448936/bfeab_400.webp,https://www.meesho.com/women-poly-georgette-aline-chikankari-orange-kurti/p/adzoo,₹519,81,28,23,13,29,174
322,https://images.meesho.com/images/products/66600864/cicny_400.webp,https://www.meesho.com/aakarsha-superior-kurtis/p/13nhk0,₹309,0,0,0,0,0,0
323,https://images.meesho.com/images/products/193992063/gdys1_400.webp,https://www.meesho.com/aagam-alluring-kurtis/p/37hx8f,₹533,0,0,0,0,0,0
324,https://images.meesho.com/images/products/180257545/nsfxn_400.webp,https://www.meesho.com/jivika-refined-kurtis/p/2zbjm1,₹341,0,0,0,0,0,0
325,https://images.meesho.com/images/products/171161762/ali4u_400.webp,https://www.meesho.com/adrika-refined-kurtis/p/2twl9e,₹364,0,0,0,0,0,0
326,https://images.meesho.com/images/products/117355612/nk5yx_400.webp,https://www.meesho.com/adrika-fashionable-kurtis/p/1xvc64,₹463,0,0,0,0,0,0
327,https://images.meesho.com/images/products/62580074/1ioah_400.webp,https://www.meesho.com/aakarsha-graceful-kurtis/p/119b3e,₹293,71,34,33,12,37,187
328,https://images.meesho.com/images/products/164169530/g3dgg_400.webp,https://www.meesho.com/alisha-petite-kurtis/p/2pqq0q,₹353,76,36,32,16,33,193
329,https://images.meesho.com/images/products/186565332/70nqo_400.webp,https://www.meesho.com/aagam-fashionable-kurtis/p/332qqc,₹606,7,1,2,1,2,13
3210,https://images.meesho.com/images/products/79789690/66p9d_400.webp,https://www.meesho.com/jivika-fabulous-kurtis/p/1bi64a,₹525,7,3,0,3,3,16
3211,https://images.meesho.com/images/products/150901681/g02pu_400.webp,https://www.meesho.com/adrika-alluring-kurtis/p/2huchd,₹321,0,0,0,0,0,0
3212,https://images.meesho.com/images/products/45263102/l2ee3_400.webp,https://www.meesho.com/chitrarekha-attractive-kurtis/p/qy58e,₹424,57,33,17,10,25,142
3213,https://images.meesho.com/images/products/34410943/cyuwg_400.webp,https://www.meesho.com/aagyeyi-alluring-kurtis/p/khjnj,₹449,34,8,5,2,4,53
3214,https://images.meesho.com/images/products/172646056/bhokw_400.webp,https://www.meesho.com/banita-petite-kurtis/p/2usejs,₹436,0,5,2,0,1,8
3215,https://images.meesho.com/images/products/177264430/gfux9_400.webp,https://www.meesho.com/aagyeyi-fabulous-kurtis/p/2xje3y,₹206,2,3,0,2,1,8
3216,https://images.meesho.com/images/products/3263225/1_400.webp,https://www.meesho.com/nayaka-gorgeous-best-danedar-georgette-womens-printed-kurtis-vol-1/p/1xxx5,₹944,9,0,0,1,4,14
3217,https://images.meesho.com/images/products/142802039/qrk0w_400.webp,https://www.meesho.com/adrika-petite-kurtis/p/2d0qrb,₹465,25,13,9,6,23,76
3218,https://images.meesho.com/images/products/128309612/go0rc_400.webp,https://www.meesho.com/banita-drishya-kurtis/p/24e4bw,₹229,124,48,39,16,35,262
3219,https://images.meesho.com/images/products/143165059/p5ujk_400.webp,https://www.meesho.com/trendy-voguish-kurtis/p/2d8iv7,₹491,7,3,1,1,4,16
3220,https://images.meesho.com/images/products/48582465/eg4fv_400.webp,https://www.meesho.com/aishani-voguish-kurtis/p/sxagx,₹540,89,38,36,20,39,222
331,https://images.meesho.com/images/products/80351299/2fzme_400.webp,https://www.meesho.com/aishani-attractive-kurtis/p/1bu7gj,"₹1,065",22,9,18,8,11,68
332,https://images.meesho.com/images/products/76884740/dmt3p_400.webp,https://www.meesho.com/adrika-drishya-kurtis/p/19rwn8,₹665,7,2,0,1,1,11
333,https://images.meesho.com/images/products/197345559/g7t7j_400.webp,https://www.meesho.com/myra-superior-kurtis/p/39hst3,₹492,14,6,1,0,6,27
334,https://images.meesho.com/images/products/176035640/xf688_400.webp,https://www.meesho.com/banita-superior-kurtis/p/2wt1yw,₹541,0,0,0,0,0,0
335,https://images.meesho.com/images/products/154510754/gixli_400.webp,https://www.meesho.com/banita-ensemble-kurtis/p/2jzp9e,₹574,2,0,0,1,2,5
336,https://images.meesho.com/images/products/112570194/ixluz_400.webp,https://www.meesho.com/kashvi-voguish-kurtis/p/1v0rpu,₹579,470,180,98,54,90,892
337,https://images.meesho.com/images/products/142785906/u5xqc_400.webp,https://www.meesho.com/aakarsha-fashionable-kurtis/p/2d0eb6,₹463,33,16,3,4,17,73
338,https://images.meesho.com/images/products/167858787/ancw1_400.webp,https://www.meesho.com/aagam-fashionable-kurtis/p/2rxso3,₹617,22,9,3,3,6,43
339,https://images.meesho.com/images/products/183020771/whvyg_400.webp,https://www.meesho.com/banita-pretty-kurtis/p/30yrqb,₹526,85,40,18,11,20,174
3310,https://images.meesho.com/images/products/149492644/auit9_400.webp,https://www.meesho.com/alisha-attractive-kurtis/p/2h059g,₹356,12,4,1,3,2,22
3311,https://images.meesho.com/images/products/74333793/rixea_400.webp,https://www.meesho.com/aakarsha-sensational-women-kurtis/p/1898bl,₹849,21,10,7,3,11,52
3312,https://images.meesho.com/images/products/173414562/x9a5l_400.webp,https://www.meesho.com/jivika-fashionable-kurtis/p/2v8vj6,₹486,9,2,0,0,4,15
3313,https://images.meesho.com/images/products/20151720/adf02_400.webp,https://www.meesho.com/myra-superior-kurtis/p/bzx60,₹541,28,7,14,2,3,54
3314,https://images.meesho.com/images/products/182083824/uzcon_400.webp,https://www.meesho.com/banita-refined-kurtis/p/30eos0,₹581,4,1,2,1,3,11
3315,https://images.meesho.com/images/products/164360420/2hxjp_400.webp,https://www.meesho.com/aishani-graceful-kurtis/p/2putb8,₹587,4,0,0,0,3,7
3316,https://images.meesho.com/images/products/58459017/6hovy_400.webp,https://www.meesho.com/adrika-graceful-kurtis/p/ysz9l,₹580,8,2,3,1,4,18
3317,https://images.meesho.com/images/products/182283680/450ie_400.webp,https://www.meesho.com/trendy-pretty-kurtis/p/30iyzk,₹665,6,3,1,0,2,12
3318,https://images.meesho.com/images/products/66351136/39faz_400.webp,https://www.meesho.com/aagam-alluring-kurtis/p/13i4v4,₹598,79,50,34,14,22,199
3319,https://images.meesho.com/images/products/50967404/pfjnu_400.webp,https://www.meesho.com/kashvi-voguish-kurtis/p/ucep8,₹696,4,0,0,0,1,5
3320,https://images.meesho.com/images/products/65397914/7xabf_400.webp,https://www.meesho.com/chitrarekha-drishya-kurtis/p/12xpcq,₹385,8,5,5,1,5,24
341,https://images.meesho.com/images/products/99542877/jywmn_400.webp,https://www.meesho.com/aagyeyi-superior-kurtis/p/1n9jrx,₹473,10,3,2,1,1,17
342,https://images.meesho.com/images/products/152553092/6szl7_400.webp,https://www.meesho.com/banita-graceful-kurtis/p/2itqpw,₹716,53,19,11,8,22,113
343,https://images.meesho.com/images/products/62266938/hg5h2_400.webp,https://www.meesho.com/adrika-superior-kurtis/p/112lh6,₹508,0,0,0,0,0,0
344,https://images.meesho.com/images/products/157448656/tttoi_400.webp,https://www.meesho.com/banita-fashionable-kurtis/p/2lqo5s,₹605,5,1,2,1,1,10
345,https://images.meesho.com/images/products/3379449/1_400.webp,https://www.meesho.com/new-nayaka-gorgeous-georgette-womens-kurtis-vol-5/p/20fll,₹867,56,32,12,7,8,115
346,https://images.meesho.com/images/products/193865202/9p6ic_400.webp,https://www.meesho.com/jivika-superior-kurtis/p/37f7ci,₹399,0,3,0,1,2,6
347,https://images.meesho.com/images/products/181566314/svznp_400.webp,https://www.meesho.com/aagyeyi-attractive-kurtis/p/303lgq,₹515,4,2,0,0,1,7
348,https://images.meesho.com/images/products/159009016/jqjeq_400.webp,https://www.meesho.com/aagam-refined-kurtis/p/2mo454,₹580,32,9,9,5,7,62
349,https://images.meesho.com/images/products/23776011/awicb_400.webp,https://www.meesho.com/kashvi-fashionable-kurtis/p/e5lor,₹220,169,52,43,32,67,363
3410,https://images.meesho.com/images/products/169341220/qj9pu_400.webp,https://www.meesho.com/myra-petite-kurtis/p/2stkis,₹183,11,6,4,3,5,29
3411,https://images.meesho.com/images/products/144789767/3ib1o_400.webp,https://www.meesho.com/aagam-pretty-kurtis/p/2e7chz,₹313,7,1,1,1,2,12
3412,https://images.meesho.com/images/products/74328854/g6dhk_400.webp,https://www.meesho.com/jivika-sensational-kurtis/p/1894ie,₹562,9,2,1,0,1,13
3413,https://images.meesho.com/images/products/174934605/z8q7i_400.webp,https://www.meesho.com/chitrarekha-sensational-kurtis/p/2w5gel,₹631,19,7,3,2,7,38
3414,https://images.meesho.com/images/products/159984820/lwkou_400.webp,https://www.meesho.com/kashvi-ensemble-kurtis/p/2n912s,₹298,4,2,1,1,1,9
3415,https://images.meesho.com/images/products/192981625/1x38g_400.webp,https://www.meesho.com/alisha-drishya-kurtis/p/36w9kp,₹571,7,2,1,0,4,14
3416,https://images.meesho.com/images/products/58424104/kmslq_400.webp,https://www.meesho.com/aakarsha-ensemble-kurtis/p/ys8bs,₹543,50,24,13,9,17,113
3417,https://images.meesho.com/images/products/51569866/z6hhw_400.webp,https://www.meesho.com/abhisarika-attractive-kurtis/p/upbka,₹584,5,2,2,1,1,11
3418,https://images.meesho.com/images/products/67213266/gynj0_400.webp,https://www.meesho.com/alisha-petite-kurtis/p/140m36,₹293,108,51,39,21,36,255
3419,https://images.meesho.com/images/products/175248003/oqcjd_400.webp,https://www.meesho.com/alisha-alluring-kurtis/p/2wc683,₹465,14,4,2,3,1,24
3420,https://images.meesho.com/images/products/149845445/g1wyi_400.webp,https://www.meesho.com/trendy-superior-kurtis/p/2h7phh,₹464,49,24,14,9,13,109
351,https://images.meesho.com/images/products/196928390/rhnao_400.webp,https://www.meesho.com/jivika-pretty-kurtis/p/398ux2,₹464,0,0,0,0,0,0
352,https://images.meesho.com/images/products/73085883/irb6n_400.webp,https://www.meesho.com/myra-attractive-kurtis/p/17ihff,₹629,32,9,7,3,7,58
353,https://images.meesho.com/images/products/146887154/gniry_400.webp,https://www.meesho.com/banita-voguish-kurtis/p/2fgauq,₹551,26,13,6,1,11,57
354,https://images.meesho.com/images/products/147655863/c2cwg_400.webp,https://www.meesho.com/aagam-attractive-kurtis/p/2fwrzr,₹503,132,36,15,15,30,228
355,https://images.meesho.com/images/products/50320399/utlbg_400.webp,https://www.meesho.com/aagyeyi-attractive-kurtis/p/tyjgv,₹552,0,0,0,0,0,0
356,https://images.meesho.com/images/products/186943776/sx78y_400.webp,https://www.meesho.com/jivika-alluring-kurtis/p/33auqo,₹312,13,4,0,0,1,18
357,https://images.meesho.com/images/products/62293419/egzyj_400.webp,https://www.meesho.com/myra-petite-kurtis/p/1135wr,₹544,71,34,12,4,14,135
358,https://images.meesho.com/images/products/126932084/sxr9m_400.webp,https://www.meesho.com/alisha-sensational-kurtis/p/23klf8,₹373,144,66,32,17,52,311
359,https://images.meesho.com/images/products/6004684/25d0e_400.webp,https://www.meesho.com/women-cotton-printed-kurti/p/3kp8s,₹373,43,21,15,3,22,104
3510,https://images.meesho.com/images/products/36405834/rsgle_400.webp,https://www.meesho.com/kashvi-graceful-kurtis/p/loax6,₹750,0,0,0,0,0,0
3511,https://images.meesho.com/images/products/26570007/34e52_400.webp,https://www.meesho.com/abhisarika-petite-kurtis/p/fthjr,₹952,17,5,4,3,0,29
3512,https://images.meesho.com/images/products/4527261/1_400.webp,https://www.meesho.com/chitrarekha-refined-kurtis/p/2p199,₹430,12,2,2,2,2,20
3513,https://images.meesho.com/images/products/73274586/o6zmj_400.webp,https://www.meesho.com/adrika-sensational-kurtis/p/17mj16,₹348,4,2,0,0,0,6
3514,https://images.meesho.com/images/products/4684008/2_400.webp,https://www.meesho.com/women-cotton-aline-embroidered-yellow-kurti/p/2se7c,₹391,11,1,0,1,2,15
3515,https://images.meesho.com/images/products/68468403/ncstl_400.webp,https://www.meesho.com/aishani-sensational-kurtis/p/14rik3,₹536,0,0,0,0,0,0
3516,https://images.meesho.com/images/products/186671710/jhmwa_400.webp,https://www.meesho.com/aishani-superior-kurtis/p/3350ta,₹674,5,1,2,0,1,9
3517,https://images.meesho.com/images/products/175152939/ug5d6_400.webp,https://www.meesho.com/myra-voguish-kurtis/p/2wa4vf,₹531,3,0,1,0,0,4
3518,https://images.meesho.com/images/products/160106791/gczu3_400.webp,https://www.meesho.com/aakarsha-superior-kurtis/p/2nbn6v,₹369,0,0,0,0,0,0
3519,https://images.meesho.com/images/products/165247914/4osr0_400.webp,https://www.meesho.com/kashvi-petite-kurtis/p/2qdu3u,₹904,2,2,0,0,0,4
3520,https://images.meesho.com/images/products/98683492/4do4e_400.webp,https://www.meesho.com/abhisarika-refined-kurtis/p/1mr4o4,₹583,11,5,2,3,1,22
361,https://images.meesho.com/images/products/167613844/ax9gn_400.webp,https://www.meesho.com/jivika-refined-kurtis/p/2rsjo4,₹464,6,4,0,1,1,12
362,https://images.meesho.com/images/products/175060862/r89mk_400.webp,https://www.meesho.com/trendy-superior-kurtis/p/2w85tq,₹356,5,1,0,1,1,8
363,https://images.meesho.com/images/products/159801394/e0pch_400.webp,https://www.meesho.com/charvi-fashionable-kurtis/p/2n53jm,₹227,3,1,0,0,0,4
364,https://images.meesho.com/images/products/158397923/voyx6_400.webp,https://www.meesho.com/banita-voguish-kurtis/p/2mb0mb,₹503,5,1,3,0,0,9
365,https://images.meesho.com/images/products/40207380/mfkzb_400.webp,https://www.meesho.com/chitrarekha-drishya-kurtis/p/nxs7o,₹584,486,209,152,89,196,1132
366,https://images.meesho.com/images/products/77091445/5kuzg_400.webp,https://www.meesho.com/aishani-petite-kurtis/p/19wc51,₹464,16,4,5,3,2,30
367,https://images.meesho.com/images/products/49372320/akfgk_400.webp,https://www.meesho.com/banita-superior-kurtis/p/te7xc,₹876,20,10,4,1,7,42
368,https://images.meesho.com/images/products/162142300/ot8wi_400.webp,https://www.meesho.com/adrika-petite-kurtis/p/2oj9ss,₹362,4,1,0,1,0,6
369,https://images.meesho.com/images/products/78160899/rhiin_400.webp,https://www.meesho.com/alisha-ensemble-kurtis/p/1aj9c3,₹397,4,1,0,1,1,7
3610,https://images.meesho.com/images/products/110689498/b4k9n_400.webp,https://www.meesho.com/abhisarika-fashionable-kurtis/p/1twgka,₹404,3,2,1,0,1,7
3611,https://images.meesho.com/images/products/51981357/9qudq_400.webp,https://www.meesho.com/aishani-superior-kurtis/p/uy52l,₹387,3,2,1,1,0,7
3612,https://images.meesho.com/images/products/123922589/8dht8_400.webp,https://www.meesho.com/festive-special-abhisarika-refined-kurtis/p/21s3a5,₹579,487,169,115,64,97,932
3613,https://images.meesho.com/images/products/159593180/kwag8_400.webp,https://www.meesho.com/aagam-pretty-kurtis/p/2n0mvw,₹566,7,0,0,0,3,10
3614,https://images.meesho.com/images/products/108508902/j4w45_400.webp,https://www.meesho.com/chitrarekha-sensational-kurtis/p/1slq06,₹476,29,8,5,4,9,55
3615,https://images.meesho.com/images/products/105725783/ux4kx_400.webp,https://www.meesho.com/adrika-voguish-kurtis/p/1qy2jb,₹515,0,0,0,0,0,0
3616,https://images.meesho.com/images/products/113679534/fxgxp_400.webp,https://www.meesho.com/adrika-attractive-kurtis/p/1vojou,₹362,122,45,31,27,38,263
3617,https://images.meesho.com/images/products/95947996/tcr4p_400.webp,https://www.meesho.com/charvi-graceful-kurtis/p/1l4hy4,₹549,60,23,12,9,23,127
3618,https://images.meesho.com/images/products/4854899/1_400.webp,https://www.meesho.com/womens-chikankari-chiffon-kurtis/p/2w22b,₹952,10,1,3,1,2,17
3619,https://images.meesho.com/images/products/75938883/gwdoi_400.webp,https://www.meesho.com/chitrarekha-sensational-kurtis/p/197mtf,₹506,40,7,11,2,16,76
3620,https://images.meesho.com/images/products/120989769/zapgu_400.webp,https://www.meesho.com/banita-pretty-kurtis/p/2018ax,₹293,10,3,2,0,5,20
371,https://images.meesho.com/images/products/59081608/mdiw5_400.webp,https://www.meesho.com/adrika-petite-kurtis/p/z6bns,₹450,0,0,0,0,0,0
372,https://images.meesho.com/images/products/17002288/785e0_400.webp,https://www.meesho.com/banita-alluring-kurtis/p/a4f1s,₹615,6,3,2,2,3,16
373,https://images.meesho.com/images/products/176714864/kthu5_400.webp,https://www.meesho.com/trendy-fabulous-kurtis/p/2x7m28,₹430,0,0,0,0,0,0
374,https://images.meesho.com/images/products/149763483/2t9wi_400.webp,https://www.meesho.com/aagam-ensemble-kurtis/p/2h5y8r,₹565,0,0,0,0,0,0
375,https://images.meesho.com/images/products/161415895/xt6fl_400.webp,https://www.meesho.com/aakarsha-alluring-kurtis/p/2o3pav,₹223,0,0,0,0,0,0
376,https://images.meesho.com/images/products/91864404/e0sjh_400.webp,https://www.meesho.com/alisha-fabulous-kurtis/p/1ioz10,₹475,0,0,0,0,0,0
377,https://images.meesho.com/images/products/165902946/d5yxa_400.webp,https://www.meesho.com/aagyeyi-refined-kurtis/p/2qrvj6,₹416,3,0,0,1,1,5
378,https://images.meesho.com/images/products/71127835/9ynth_400.webp,https://www.meesho.com/aakarsha-graceful-kurtis/p/16cil7,₹344,275,126,99,69,105,674
379,https://images.meesho.com/images/products/180204840/b1pv0_400.webp,https://www.meesho.com/adrika-petite-kurtis/p/2zaey0,₹439,3,1,1,1,1,7
3710,https://images.meesho.com/images/products/62515649/wsozb_400.webp,https://www.meesho.com/aishani-petite-kurtis/p/117xdt,₹294,44,29,25,9,19,126
3711,https://images.meesho.com/images/products/2677558/1_400.webp,https://www.meesho.com/women-georgette-aline-chikankari-orange-kurti/p/1le0m,₹618,84,36,21,12,39,192
3712,https://images.meesho.com/images/products/26660329/d34a7_400.webp,https://www.meesho.com/kashvi-fashionable-kurtis/p/fvf8p,₹450,49,22,14,12,13,110
3713,https://images.meesho.com/images/products/171404280/har9j_400.webp,https://www.meesho.com/abhisarika-petite-kurtis/p/2u1se0,₹304,0,0,0,0,0,0
3714,https://images.meesho.com/images/products/179714163/2vxxu_400.webp,https://www.meesho.com/aagam-sensational-kurtis/p/2yzwc3,₹539,2,0,0,2,0,4
3715,https://images.meesho.com/images/products/194590724/ue0p4_400.webp,https://www.meesho.com/trendy-refined-kurtis/p/37ur5w,₹342,1,1,1,1,0,4
3716,https://images.meesho.com/images/products/143964637/kcgjg_400.webp,https://www.meesho.com/myra-attractive-kurtis/p/2dpntp,₹439,9,4,2,3,4,22
3717,https://images.meesho.com/images/products/18566478/22981_400.webp,https://www.meesho.com/women-chiffon-chikankari-mustard-kurti/p/b1xzi,₹581,190,105,62,35,90,482
3718,https://images.meesho.com/images/products/68439776/lmrhk_400.webp,https://www.meesho.com/abhisarika-drishya-kurtis/p/14qwgw,₹541,3,0,0,0,2,5
3719,https://images.meesho.com/images/products/61578655/8dgcn_400.webp,https://www.meesho.com/trendy-fashionable-kurtis/p/10nue7,₹310,6,2,8,3,2,21
3720,https://images.meesho.com/images/products/32050725/5e513_400.webp,https://www.meesho.com/myra-ensemble-kurtis/p/j2yhx,₹628,52,23,20,13,19,127
381,https://images.meesho.com/images/products/196843754/xqg4c_400.webp,https://www.meesho.com/aagam-fabulous-kurtis/p/3971m2,₹440,9,3,1,0,2,15
382,https://images.meesho.com/images/products/196926298/9j7ay_400.webp,https://www.meesho.com/abhisarika-voguish-kurtis/p/398tay,₹385,0,0,0,0,0,0
383,https://images.meesho.com/images/products/57483104/k8jq5_400.webp,https://www.meesho.com/aakarsha-pretty-kurtis/p/y828w,₹511,178,73,46,34,71,402
384,https://images.meesho.com/images/products/180212044/hsrmd_400.webp,https://www.meesho.com/abhisarika-superior-kurtis/p/2zaki4,₹446,3,1,3,2,3,12
385,https://images.meesho.com/images/products/71434158/hkgzm_400.webp,https://www.meesho.com/aishani-sensational-kurtis/p/16j2y6,₹507,92,37,20,11,14,174
386,https://images.meesho.com/images/products/144386480/5urjp_400.webp,https://www.meesho.com/aakarsha-refined-kurtis/p/2dypbk,₹305,87,38,26,21,30,202
387,https://images.meesho.com/images/products/41988360/td8s7_400.webp,https://www.meesho.com/aagam-alluring-kurtis/p/ozyfc,₹574,185,102,43,34,34,398
388,https://images.meesho.com/images/products/172728777/1b2da_400.webp,https://www.meesho.com/jivika-ensemble-kurtis/p/2uu6dl,₹491,0,0,0,0,0,0
389,https://images.meesho.com/images/products/77103485/zatpq_400.webp,https://www.meesho.com/alisha-sensational-kurtis/p/19wlfh,₹369,48,20,14,8,20,110
3810,https://images.meesho.com/images/products/25541901/5458c_400.webp,https://www.meesho.com/festive-special-aishani-sensational-kurtis/p/f7g99,₹679,1706,743,446,284,554,3733
3811,https://images.meesho.com/images/products/59054814/ta6rb_400.webp,https://www.meesho.com/adrika-refined-kurtis/p/z5qzi,₹337,54,30,25,15,29,153
3812,https://images.meesho.com/images/products/162927589/vl6gm_400.webp,https://www.meesho.com/myra-pretty-kurtis/p/2p03qd,₹338,0,0,0,0,0,0
3813,https://images.meesho.com/images/products/73120316/ldow8_400.webp,https://www.meesho.com/charvi-drishya-kurtis/p/17j7zw,₹476,0,0,0,0,0,0
3814,https://images.meesho.com/images/products/67457909/i764z_400.webp,https://www.meesho.com/myra-sensational-kurtis/p/145uut,₹390,50,14,11,8,17,100
3815,https://images.meesho.com/images/products/70127516/owiyb_400.webp,https://www.meesho.com/myra-sensational-kurtis/p/15r2qk,₹343,9,5,0,2,5,21
3816,https://images.meesho.com/images/products/131485698/b4bpi_400.webp,https://www.meesho.com/trendy-alluring-kurtis/p/26a70i,₹362,232,68,46,31,36,413
3817,https://images.meesho.com/images/products/174288054/ogqyj_400.webp,https://www.meesho.com/myra-fabulous-kurtis/p/2vrliu,₹307,2,2,0,1,2,7
3818,https://images.meesho.com/images/products/47258984/owvbt_400.webp,https://www.meesho.com/aakarsha-ensemble-kurtis/p/s4x9k,₹685,163,61,35,23,42,324
3819,https://images.meesho.com/images/products/67242100/x0icw_400.webp,https://www.meesho.com/attractive-beautiful-cotton-kurtis/p/1418c4,₹293,575,225,227,158,319,1504
3820,https://images.meesho.com/images/products/169510075/0rhj0_400.webp,https://www.meesho.com/chitrarekha-fabulous-kurtis/p/2sx6t7,₹581,0,0,0,0,0,0
391,https://images.meesho.com/images/products/136382862/vxxnf_400.webp,https://www.meesho.com/chitrarekha-graceful-kurtis/p/2975ou,₹626,9,2,2,2,6,21
392,https://images.meesho.com/images/products/79172516/yqt5r_400.webp,https://www.meesho.com/alisha-superior-kurtis/p/1b4xwk,₹565,109,43,27,9,10,198
393,https://images.meesho.com/images/products/128059047/gm2n3_400.webp,https://www.meesho.com/banita-drishya-kurtis/p/248qzr,₹581,19,12,9,4,8,52
394,https://images.meesho.com/images/products/186202482/rqiq4_400.webp,https://www.meesho.com/kashvi-voguish-kurtis/p/32uyr6,₹379,29,8,7,10,9,63
395,https://images.meesho.com/images/products/63386056/vsybp_400.webp,https://www.meesho.com/myra-ensemble-kurtis/p/11qkzs,₹436,29,9,7,5,12,62
396,https://images.meesho.com/images/products/166463371/xoone_400.webp,https://www.meesho.com/banita-sensational-kurtis/p/2r3vyj,₹440,9,1,1,0,4,15
397,https://images.meesho.com/images/products/57400878/uqdvx_400.webp,https://www.meesho.com/alisha-pretty-kurtis/p/y6asu,₹465,44,14,15,9,11,93
398,https://images.meesho.com/images/products/63351957/toquy_400.webp,https://www.meesho.com/festive-special-myra-alluring-kurtis/p/11puol,₹525,279,97,76,52,68,572
399,https://images.meesho.com/images/products/169331158/tqomi_400.webp,https://www.meesho.com/aagyeyi-alluring-kurtis/p/2stcra,₹182,2,1,4,0,0,7
3910,https://images.meesho.com/images/products/143321510/zgk2o_400.webp,https://www.meesho.com/trendy-attractive-kurtis/p/2dbvl2,₹640,27,5,2,2,1,37
3911,https://images.meesho.com/images/products/76726481/33a4x_400.webp,https://www.meesho.com/aagam-fashionable-kurtis/p/19oij5,₹815,47,13,10,2,6,78
3912,https://images.meesho.com/images/products/60868107/h09pr_400.webp,https://www.meesho.com/myra-ensemble-kurtis/p/108m4r,₹538,226,115,68,49,85,543
3913,https://images.meesho.com/images/products/46145733/tywdg_400.webp,https://www.meesho.com/trendy-fashionable-kurtis/p/rh29x,"₹1,047",30,2,3,4,8,47
3914,https://images.meesho.com/images/products/176573320/iqsow_400.webp,https://www.meesho.com/aagam-alluring-kurtis/p/2x4kug,₹439,14,4,5,2,10,35
3915,https://images.meesho.com/images/products/186669888/8zoxp_400.webp,https://www.meesho.com/charvi-attractive-kurtis/p/334zeo,₹676,20,2,4,0,11,37
3916,https://images.meesho.com/images/products/101765723/cbjui_400.webp,https://www.meesho.com/aagyeyi-alluring-kurtis/p/1ol6xn,₹525,5,2,2,3,0,12
3917,https://images.meesho.com/images/products/68698381/wptdx_400.webp,https://www.meesho.com/myra-graceful-kurtis/p/14wg0d,₹583,3,0,1,0,2,6
3918,https://images.meesho.com/images/products/149399417/iu2ug_400.webp,https://www.meesho.com/charvi-ensemble-kurtis/p/2gy5bt,₹695,0,0,0,0,0,0
3919,https://images.meesho.com/images/products/47183703/2n3ji_400.webp,https://www.meesho.com/festive-special-jivika-drishya-kurtis/p/s3b6f,₹715,28,9,7,4,6,54
3920,https://images.meesho.com/images/products/197492503/harm3_400.webp,https://www.meesho.com/banita-fashionable-kurtis/p/39ky6v,₹343,3,1,0,0,3,7
401,https://images.meesho.com/images/products/57825192/5mos5_400.webp,https://www.meesho.com/chitrarekha-attractive-kurtis/p/yfe7c,₹569,96,31,32,17,28,204
402,https://images.meesho.com/images/products/156156073/0iwxi_400.webp,https://www.meesho.com/aishani-voguish-kurtis/p/2kyysp,₹579,11,3,2,0,5,21
403,https://images.meesho.com/images/products/183920219/thljx_400.webp,https://www.meesho.com/aakarsha-attractive-kurtis/p/31i1qz,₹516,0,0,0,0,0,0
404,https://images.meesho.com/images/products/61876300/huvqk_400.webp,https://www.meesho.com/aagyeyi-fashionable-kurtis/p/10u824,₹491,144,65,37,33,70,349
405,https://images.meesho.com/images/products/32667278/9mpmt_400.webp,https://www.meesho.com/alisha-drishya-kurtis/p/jg68e,₹739,1,2,1,1,3,8
406,https://images.meesho.com/images/products/56357055/ix0ar_400.webp,https://www.meesho.com/festive-special-myra-attractive-kurtis/p/xjxdr,₹541,160,78,42,19,18,317
407,https://images.meesho.com/images/products/44872164/dgryp_400.webp,https://www.meesho.com/banita-attractive-kurtis/p/qprl0,₹771,17,7,2,1,2,29
408,https://images.meesho.com/images/products/17848142/274e6_400.webp,https://www.meesho.com/banita-alluring-kurtis/p/amjpq,₹510,26,8,3,3,6,46
409,https://images.meesho.com/images/products/186910765/ip4sl_400.webp,https://www.meesho.com/adrika-pretty-kurtis/p/33a59p,₹495,7,1,0,1,1,10
4010,https://images.meesho.com/images/products/41651914/sxoqi_400.webp,https://www.meesho.com/aagyeyi-fashionable-kurtis/p/osqtm,₹455,60,25,20,9,21,135
4011,https://images.meesho.com/images/products/37638819/r6coz_400.webp,https://www.meesho.com/alisha-superior-kurtis/p/meqar,₹656,16,2,2,3,4,27
4012,https://images.meesho.com/images/products/49801941/uiv8v_400.webp,https://www.meesho.com/adrika-superior-kurtis/p/tnff9,₹666,17,5,3,0,1,26
4013,https://images.meesho.com/images/products/2420269/1_400.webp,https://www.meesho.com/alisha-trendy-chiffon-georgette-womens-kurtis-vol-1/p/1fvhp,₹958,34,11,5,2,4,56
4014,https://images.meesho.com/images/products/76774927/whbay_400.webp,https://www.meesho.com/trendy-ensemble-kurtis/p/19pjwv,"₹1,061",4,2,0,0,1,7
4015,https://images.meesho.com/images/products/66050197/rbmhs_400.webp,https://www.meesho.com/adrika-pretty-kurtis/p/13bonp,₹306,5,1,3,0,0,9
4016,https://images.meesho.com/images/products/65548029/at3sr_400.webp,https://www.meesho.com/aagyeyi-drishya-kurtis/p/130x6l,₹965,16,7,3,0,2,28
4017,https://images.meesho.com/images/products/75530683/u2sva_400.webp,https://www.meesho.com/aagyeyi-superior-kurtis/p/18yvuj,₹861,0,0,0,0,0,0
4018,https://images.meesho.com/images/products/45456523/upq2y_400.webp,https://www.meesho.com/adrika-attractive-kurtis/p/r2ah7,₹375,4,1,1,0,4,10
4019,https://images.meesho.com/images/products/63940168/8xhj7_400.webp,https://www.meesho.com/chitrarekha-sensational-kurtis/p/122gjs,₹306,0,0,0,0,0,0
4020,https://images.meesho.com/images/products/53617243/tk0s5_400.webp,https://www.meesho.com/trendy-ensemble-kurtis/p/vx7bv,₹596,9,4,4,0,0,17
411,https://images.meesho.com/images/products/181129451/ypnpg_400.webp,https://www.meesho.com/aagam-ensemble-kurtis/p/2zu8dn,₹564,5,1,0,0,1,7
412,https://images.meesho.com/images/products/158990051/80wdn_400.webp,https://www.meesho.com/aishani-voguish-kurtis/p/2mnpib,₹376,0,0,0,0,0,0
413,https://images.meesho.com/images/products/169342443/ylkra_400.webp,https://www.meesho.com/myra-attractive-kurtis/p/2stlgr,₹183,0,0,0,0,0,0
414,https://images.meesho.com/images/products/144392541/1sren_400.webp,https://www.meesho.com/adrika-ensemble-kurtis/p/2dytzx,₹599,0,0,0,0,0,0
415,https://images.meesho.com/images/products/164362124/pmnfm_400.webp,https://www.meesho.com/myra-petite-kurtis/p/2puumk,₹560,3,2,0,0,0,5
416,https://images.meesho.com/images/products/179601404/xq8qr_400.webp,https://www.meesho.com/aagam-voguish-kurtis/p/2yxhbw,₹815,3,2,0,1,0,6
417,https://images.meesho.com/images/products/189010981/z6wod_400.webp,https://www.meesho.com/aishani-fabulous-kurtis/p/34j5t1,₹661,0,0,0,0,0,0
418,https://images.meesho.com/images/products/126317431/ozx6k_400.webp,https://www.meesho.com/charvi-fashionable-kurtis/p/237f5j,₹585,7,2,3,1,0,13
419,https://images.meesho.com/images/products/183833313/1nyen_400.webp,https://www.meesho.com/myra-fabulous-kurtis/p/31g6ox,₹311,0,0,0,0,0,0
4110,https://images.meesho.com/images/products/110385766/j6v8e_400.webp,https://www.meesho.com/chitrarekha-ensemble-kurtis/p/1tpy7a,₹260,3,0,1,0,0,4
4111,https://images.meesho.com/images/products/172066961/q40cn_400.webp,https://www.meesho.com/adrika-petite-kurtis/p/2ufzpt,₹701,0,0,0,0,0,0
4112,https://images.meesho.com/images/products/126095597/ckl3b_400.webp,https://www.meesho.com/alisha-superior-kurtis/p/232nzh,₹302,0,0,0,0,0,0
4113,https://images.meesho.com/images/products/175288955/jjkz6_400.webp,https://www.meesho.com/kashvi-refined-kurtis/p/2wd1tn,₹404,0,0,0,0,0,0
4114,https://images.meesho.com/images/products/172019126/nyri0_400.webp,https://www.meesho.com/trendy-fabulous-kurtis/p/2ueyt2,₹464,0,0,0,0,0,0
4115,https://images.meesho.com/images/products/156450684/sjkfr_400.webp,https://www.meesho.com/adrika-superior-kurtis/p/2l5a4c,₹510,5,1,0,1,1,8
4116,https://images.meesho.com/images/products/178198595/juycg_400.webp,https://www.meesho.com/abhisarika-drishya-kurtis/p/2y3ewz,₹710,0,0,0,0,0,0
4117,https://images.meesho.com/images/products/166078265/j5uwd_400.webp,https://www.meesho.com/aishani-fashionable-kurtis/p/2qvmt5,₹558,2,2,2,0,0,6
4118,https://images.meesho.com/images/products/165697017/mzdb5_400.webp,https://www.meesho.com/jivika-ensemble-kurtis/p/2qngmx,₹445,0,0,0,0,0,0
4119,https://images.meesho.com/images/products/187900650/4l0po_400.webp,https://www.meesho.com/kashvi-fabulous-kurtis/p/33vd2i,₹464,0,0,0,0,0,0
4120,https://images.meesho.com/images/products/106781689/8qvau_400.webp,https://www.meesho.com/banita-pretty-kurtis/p/1rkpa1,₹965,9,1,1,0,1,12
421,https://images.meesho.com/images/products/142200343/kfjrd_400.webp,https://www.meesho.com/trendy-petite-kurtis/p/2cnuhj,₹603,6,0,0,0,0,6
422,https://images.meesho.com/images/products/155402165/c7sgo_400.webp,https://www.meesho.com/abhisarika-petite-kurtis/p/2kit2t,₹496,0,0,0,0,0,0
423,https://images.meesho.com/images/products/145478911/cpjay_400.webp,https://www.meesho.com/charvi-fashionable-kurtis/p/2em48v,₹333,5,5,0,0,1,11
424,https://images.meesho.com/images/products/161389448/umnyx_400.webp,https://www.meesho.com/jivika-voguish-kurtis/p/2o34w8,₹362,0,0,0,0,0,0
425,https://images.meesho.com/images/products/72102251/nwndb_400.webp,https://www.meesho.com/alisha-fabulous-kurtis/p/16xegb,₹710,69,22,5,10,15,121
426,https://images.meesho.com/images/products/173111580/uoi2y_400.webp,https://www.meesho.com/banita-attractive-kurtis/p/2v2dr0,₹681,5,2,1,1,1,10
427,https://images.meesho.com/images/products/40206495/haung_400.webp,https://www.meesho.com/festive-special-myra-superior-kurtis/p/nxrj3,₹370,1185,535,257,118,134,2229
428,https://images.meesho.com/images/products/70908266/wnpz4_400.webp,https://www.meesho.com/jivika-petite-kurtis/p/167t62,₹603,84,33,23,11,22,173
429,https://images.meesho.com/images/products/76178106/mzzuj_400.webp,https://www.meesho.com/trendy-petite-kurtis/p/19crei,₹486,344,150,99,48,86,727
4210,https://images.meesho.com/images/products/1046868/xe7p8_400.webp,https://www.meesho.com/alisha-alluring-attractive-georgette-chikankari-kurtis-vol-1/p/mfro,₹388,38,11,9,4,10,72
4211,https://images.meesho.com/images/products/75936183/8vmta_400.webp,https://www.meesho.com/aakarsha-ensemble-kurtis/p/197kqf,₹506,22,5,8,4,3,42
4212,https://images.meesho.com/images/products/145340983/knzls_400.webp,https://www.meesho.com/banita-fashionable-kurtis/p/2ej5tj,₹333,3,0,1,0,1,5
4213,https://images.meesho.com/images/products/130031302/hbpet_400.webp,https://www.meesho.com/jivika-fabulous-kurtis/p/25f0sm,₹515,4,3,0,0,2,9
4214,https://images.meesho.com/images/products/45258194/gbbyp_400.webp,https://www.meesho.com/kashvi-ensemble-kurtis/p/qy1g2,₹439,121,41,37,20,42,261
4215,https://images.meesho.com/images/products/163139200/v8k3w_400.webp,https://www.meesho.com/aagyeyi-sensational-kurtis/p/2p4n0g,₹641,1,5,0,0,1,7
4216,https://images.meesho.com/images/products/167289245/1k1yz_400.webp,https://www.meesho.com/aishani-sensational-kurtis/p/2rll7h,₹455,9,6,3,2,3,23
4217,https://images.meesho.com/images/products/117396577/tmarr_400.webp,https://www.meesho.com/trendy-pretty-kurtis/p/1xw7s1,₹232,26,6,8,4,9,53
4218,https://images.meesho.com/images/products/120965524/9ypka_400.webp,https://www.meesho.com/myra-alluring-kurtis/p/200plg,₹290,7,5,1,0,3,16
4219,https://images.meesho.com/images/products/146243076/nugs8_400.webp,https://www.meesho.com/kashvi-fashionable-kurtis/p/2f2hvo,₹538,4,1,2,1,1,9
4220,https://images.meesho.com/images/products/181619480/hibn6_400.webp,https://www.meesho.com/aagam-petite-kurtis/p/304qhk,₹380,0,0,0,0,0,0
431,https://images.meesho.com/images/products/159921568/g11qe_400.webp,https://www.meesho.com/banita-attractive-kurtis/p/2n7o9s,₹477,0,0,0,0,0,0
432,https://images.meesho.com/images/products/77605825/jnjy9_400.webp,https://www.meesho.com/trendy-graceful-kurtis/p/1a7d1d,₹468,16,8,5,6,5,40
433,https://images.meesho.com/images/products/66340780/aktk0_400.webp,https://www.meesho.com/charvi-attractive-kurtis/p/13hwvg,₹592,14,4,5,6,3,32
434,https://images.meesho.com/images/products/89125376/adgtf_400.webp,https://www.meesho.com/banita-fabulous-kurtis/p/1h29kw,₹565,8,3,3,3,2,19
435,https://images.meesho.com/images/products/41384327/0ohzy_400.webp,https://www.meesho.com/myra-graceful-kurtis/p/on0cn,₹670,7,2,4,1,5,19
436,https://images.meesho.com/images/products/62860131/682vo_400.webp,https://www.meesho.com/myra-drishya-kurtis/p/11fb6r,₹318,0,0,0,0,0,0
437,https://images.meesho.com/images/products/62702272/ctqem_400.webp,https://www.meesho.com/aagyeyi-petite-kurtis/p/11bxds,₹565,9,6,2,0,6,23
438,https://images.meesho.com/images/products/13831520/2c2a6_400.webp,https://www.meesho.com/aagyeyi-drishya-kurtis/p/88ggw,₹397,0,0,0,0,0,0
439,https://images.meesho.com/images/products/192391417/cvchm_400.webp,https://www.meesho.com/aishani-petite-kurtis/p/36jm61,₹565,0,0,0,0,0,0
4310,https://images.meesho.com/images/products/189326374/lcuiu_400.webp,https://www.meesho.com/kashvi-pretty-kurtis/p/34px5y,₹694,0,0,0,0,0,0
4311,https://images.meesho.com/images/products/174320993/vt7bp_400.webp,https://www.meesho.com/abhisarika-sensational-kurtis/p/2vsaxt,₹303,0,0,0,0,0,0
4312,https://images.meesho.com/images/products/191439351/q9ckr_400.webp,https://www.meesho.com/abhisarika-attractive-kurtis/p/35z7jr,₹406,0,0,0,0,0,0
4313,https://images.meesho.com/images/products/150923526/xyqa4_400.webp,https://www.meesho.com/adrika-refined-kurtis/p/2hutc6,₹366,0,0,0,0,0,0
4314,https://images.meesho.com/images/products/172022030/et5im_400.webp,https://www.meesho.com/trendy-drishya-kurtis/p/2uf11q,₹464,0,0,0,0,0,0
4315,https://images.meesho.com/images/products/170560916/mpt37_400.webp,https://www.meesho.com/chitrarekha-alluring-kurtis/p/2tjpn8,₹374,0,0,0,0,0,0
4316,https://images.meesho.com/images/products/73116268/qjgcd_400.webp,https://www.meesho.com/kashvi-petite-kurtis/p/17j4vg,₹476,29,13,13,5,11,71
4317,https://images.meesho.com/images/products/58965504/kkh2g_400.webp,https://www.meesho.com/aakarsha-fabulous-kurtis/p/z3u2o,₹555,14,4,3,2,4,27
4318,https://images.meesho.com/images/products/49872107/c23q4_400.webp,https://www.meesho.com/aakarsha-alluring-kurtis/p/toxkb,₹539,25,11,12,3,10,61
4319,https://images.meesho.com/images/products/141561891/wggbz_400.webp,https://www.meesho.com/trendy-superior-kurtis/p/2ca5ur,₹534,32,15,12,6,15,80
4320,https://images.meesho.com/images/products/143280419/fwapq_400.webp,https://www.meesho.com/trendy-fabulous-kurtis/p/2dazvn,₹521,0,0,0,0,0,0
441,https://images.meesho.com/images/products/77604112/ahlxa_400.webp,https://www.meesho.com/adrika-alluring-kurtis/p/1a7bps,₹474,14,10,3,5,6,38
442,https://images.meesho.com/images/products/45413477/cgmfm_400.webp,https://www.meesho.com/charvi-alluring-kurtis/p/r1d9h,₹564,89,36,29,19,33,206
443,https://images.meesho.com/images/products/145700924/3ycni_400.webp,https://www.meesho.com/abhisarika-graceful-kurtis/p/2eqvjw,₹333,25,3,13,5,8,54
444,https://images.meesho.com/images/products/7022389/a690e_400.webp,https://www.meesho.com/women-cotton-aline-chikankari-yellow-kurti/p/46iid,₹487,67,49,20,6,25,167
445,https://images.meesho.com/images/products/160260302/teo4l_400.webp,https://www.meesho.com/abhisarika-refined-kurtis/p/2nexn2,₹515,0,0,0,0,0,0
446,https://images.meesho.com/images/products/154979986/3t5ui_400.webp,https://www.meesho.com/abhisarika-alluring-kurtis/p/2k9rbm,₹333,0,0,0,0,0,0
447,https://images.meesho.com/images/products/176592439/sptyj_400.webp,https://www.meesho.com/trendy-sensational-kurtis/p/2x4zlj,₹541,5,1,3,1,2,12
448,https://images.meesho.com/images/products/172882650/0jsrs_400.webp,https://www.meesho.com/abhisarika-superior-kurtis/p/2uxh3u,₹293,24,6,5,5,12,52
449,https://images.meesho.com/images/products/143547701/ktzsv_400.webp,https://www.meesho.com/banita-fabulous-kurtis/p/2dgq45,₹311,8,4,1,1,5,19
4410,https://images.meesho.com/images/products/141639738/afudw_400.webp,https://www.meesho.com/aagam-refined-kurtis/p/2cbtx6,₹414,14,4,4,3,7,32
4411,https://images.meesho.com/images/products/142323275/etlxz_400.webp,https://www.meesho.com/charvi-sensational-kurtis/p/2cqhcb,₹565,16,8,4,2,10,40
4412,https://images.meesho.com/images/products/49838116/2ejdm_400.webp,https://www.meesho.com/trendy-graceful-kurtis/p/to7c4,₹298,139,42,37,33,68,319
4413,https://images.meesho.com/images/products/35240366/qny2s_400.webp,https://www.meesho.com/trendy-fashionable-kurtis/p/kzbn2,₹344,30,18,15,8,14,85
4414,https://images.meesho.com/images/products/140151731/t91h2_400.webp,https://www.meesho.com/kashvi-superior-kurtis/p/2bfxrn,₹507,38,21,16,10,22,107
4415,https://images.meesho.com/images/products/56131422/63swt_400.webp,https://www.meesho.com/chitrarekha-fabulous-kurtis/p/xf3a6,₹302,4,0,0,0,2,6
4416,https://images.meesho.com/images/products/151335410/q87x8_400.webp,https://www.meesho.com/trendy-voguish-kurtis/p/2i3n5e,₹294,9,2,3,0,6,20
4417,https://images.meesho.com/images/products/173325476/fzidc_400.webp,https://www.meesho.com/charvi-pretty-kurtis/p/2v6ysk,₹540,6,4,1,0,5,16
4418,https://images.meesho.com/images/products/69481470/1czjy_400.webp,https://www.meesho.com/aakarsha-fabulous-kurtis/p/15d88u,₹529,77,32,36,18,48,211
4419,https://images.meesho.com/images/products/165267209/uanc9_400.webp,https://www.meesho.com/aagyeyi-pretty-kurtis/p/2qe8zt,₹463,0,0,0,0,0,0
4420,https://images.meesho.com/images/products/156527645/ajltl_400.webp,https://www.meesho.com/aagam-drishya-kurtis/p/2l6xi5,₹603,9,4,7,3,6,29
451,https://images.meesho.com/images/products/73591472/r0gcx_400.webp,https://www.meesho.com/jivika-fabulous-kurtis/p/17tbjk,₹531,79,30,22,10,20,161
452,https://images.meesho.com/images/products/60870550/u0hnb_400.webp,https://www.meesho.com/aishani-petite-kurtis/p/108o0m,₹346,3,2,1,0,3,9
453,https://images.meesho.com/images/products/171154460/rm32f_400.webp,https://www.meesho.com/kashvi-drishya-kurtis/p/2twfmk,₹671,4,0,0,1,3,8
454,https://images.meesho.com/images/products/43943779/fxwjk_400.webp,https://www.meesho.com/banita-fashionable-kurtis/p/q5v8j,₹399,0,0,0,0,0,0
455,https://images.meesho.com/images/products/172068652/gokqy_400.webp,https://www.meesho.com/kashvi-graceful-kurtis/p/2ug10s,₹625,0,0,0,0,0,0
456,https://images.meesho.com/images/products/118854899/cncfa_400.webp,https://www.meesho.com/aagyeyi-refined-kurtis/p/1yrh0z,₹485,0,0,0,0,0,0
457,https://images.meesho.com/images/products/60094579/dmqqt_400.webp,https://www.meesho.com/banita-attractive-kurtis/p/zs19v,₹943,17,3,4,3,3,30
458,https://images.meesho.com/images/products/180514543/qfocj_400.webp,https://www.meesho.com/jivika-drishya-kurtis/p/2zh1wv,₹625,0,0,0,0,0,0
459,https://images.meesho.com/images/products/148116647/cqqup_400.webp,https://www.meesho.com/alisha-drishya-kurtis/p/2g6njb,₹451,20,6,2,2,7,37
4510,https://images.meesho.com/images/products/122226774/b4jfy_400.webp,https://www.meesho.com/trendy-superior-kurtis/p/20rqs6,₹306,72,42,30,19,27,190
4511,https://images.meesho.com/images/products/72747599/ecnya_400.webp,https://www.meesho.com/alisha-alluring-kurtis/p/17b8en,₹314,34,6,12,4,8,64
4512,https://images.meesho.com/images/products/179197264/3iyku_400.webp,https://www.meesho.com/banita-ensemble-kurtis/p/2yoths,₹217,5,3,0,1,4,13
4513,https://images.meesho.com/images/products/171273510/10atk_400.webp,https://www.meesho.com/charvi-voguish-kurtis/p/2tyzhi,₹288,0,0,0,0,0,0
4514,https://images.meesho.com/images/products/120434851/plvpl_400.webp,https://www.meesho.com/zola-georgette-ethinic-wear-lucknowi-chikankari-kurta-for-women/p/1zpc4j,"₹1,165",0,0,0,0,0,0
4515,https://images.meesho.com/images/products/141721972/wlln8_400.webp,https://www.meesho.com/aakarsha-refined-kurtis/p/2cdldg,₹522,6,3,0,2,4,15
4516,https://images.meesho.com/images/products/162031707/ovhlj_400.webp,https://www.meesho.com/trendy-pretty-kurtis/p/2ogwgr,₹578,55,17,16,9,9,106
4517,https://images.meesho.com/images/products/166871960/wiqpj_400.webp,https://www.meesho.com/abhisarika-sensational-kurtis/p/2rcn88,₹261,0,0,0,0,0,0
4518,https://images.meesho.com/images/products/70888590/ufgas_400.webp,https://www.meesho.com/charvi-ensemble-kurtis/p/167dzi,₹434,113,58,42,16,58,287
4519,https://images.meesho.com/images/products/140986523/earqj_400.webp,https://www.meesho.com/adrika-fabulous-kurtis/p/2bxtwb,₹429,84,36,28,17,21,186
4520,https://images.meesho.com/images/products/195367009/vnydr_400.webp,https://www.meesho.com/chitrarekha-superior-kurtis/p/38be5d,₹499,0,0,0,0,0,0
461,https://images.meesho.com/images/products/163099351/nouze_400.webp,https://www.meesho.com/jivika-superior-kurtis/p/2p3s9j,₹511,0,0,0,0,0,0
462,https://images.meesho.com/images/products/186940964/suq9z_400.webp,https://www.meesho.com/myra-pretty-kurtis/p/33askk,₹312,8,3,1,0,2,14
463,https://images.meesho.com/images/products/120336908/an2rr_400.webp,https://www.meesho.com/aakarsha-voguish-kurtis/p/1zn8jw,₹546,27,7,6,2,5,47
464,https://images.meesho.com/images/products/125786676/ebmn0_400.webp,https://www.meesho.com/myra-ensemble-kurtis/p/22w1mc,₹309,95,38,26,16,15,190
465,https://images.meesho.com/images/products/46675876/zdld8_400.webp,https://www.meesho.com/aagyeyi-superior-kurtis/p/rsfc4,₹354,56,23,13,6,16,114
466,https://images.meesho.com/images/products/50709454/o2wym_400.webp,https://www.meesho.com/charvi-superior-kurtis/p/u6vny,₹285,4,1,1,0,5,11
467,https://images.meesho.com/images/products/148476188/gaiss_400.webp,https://www.meesho.com/adrika-fabulous-kurtis/p/2gecyk,₹326,0,0,0,0,0,0
468,https://images.meesho.com/images/products/151616461/l79b5_400.webp,https://www.meesho.com/banita-refined-kurtis/p/2i9o0d,₹341,9,1,0,1,4,15
469,https://images.meesho.com/images/products/71431195/k5uis_400.webp,https://www.meesho.com/abhisarika-alluring-kurtis/p/16j0nv,₹507,111,42,21,9,24,207
4610,https://images.meesho.com/images/products/65114957/ngm0w_400.webp,https://www.meesho.com/myra-fabulous-kurtis/p/12rn0t,₹361,1,0,1,0,2,4
4611,https://images.meesho.com/images/products/143626007/jjolj_400.webp,https://www.meesho.com/aagam-sensational-kurtis/p/2diejb,₹292,84,38,32,16,49,219
4612,https://images.meesho.com/images/products/91146308/rpgmn_400.webp,https://www.meesho.com/banita-graceful-kurtis/p/1i9kxw,₹865,9,2,4,2,7,24
4613,https://images.meesho.com/images/products/139114899/ln1ry_400.webp,https://www.meesho.com/charvi-alluring-kurtis/p/2atpqr,₹414,4,2,0,2,0,8
4614,https://images.meesho.com/images/products/182434884/ozbjh_400.webp,https://www.meesho.com/kashvi-voguish-kurtis/p/30m7no,₹615,0,0,0,0,0,0
4615,https://images.meesho.com/images/products/115607175/hljrf_400.webp,https://www.meesho.com/aagyeyi-fashionable-kurtis/p/1wtv2f,₹291,122,47,40,34,60,303
4616,https://images.meesho.com/images/products/29306843/ikd2j_400.webp,https://www.meesho.com/alisha-drishya-kurtis/p/hg5az,₹527,292,144,75,38,81,630
4617,https://images.meesho.com/images/products/65526306/ljlpu_400.webp,https://www.meesho.com/adrika-attractive-kurtis/p/130gf6,₹965,39,18,4,3,5,69
4618,https://images.meesho.com/images/products/155561476/eymix_400.webp,https://www.meesho.com/jivika-refined-kurtis/p/2km804,₹666,0,0,0,0,0,0
4619,https://images.meesho.com/images/products/139760200/vtxmn_400.webp,https://www.meesho.com/aishani-refined-kurtis/p/2b7jns,₹416,94,67,33,21,29,244
4620,https://images.meesho.com/images/products/161107452/1w4ug_400.webp,https://www.meesho.com/banita-superior-kurtis/p/2nx3b0,₹476,6,5,3,3,3,20
471,https://images.meesho.com/images/products/149987336/ctqon_400.webp,https://www.meesho.com/alisha-sensational-kurtis/p/2haqyw,₹439,34,16,10,5,8,73
472,https://images.meesho.com/images/products/125361109/vsh2m_400.webp,https://www.meesho.com/myra-superior-kurtis/p/22mx91,₹385,172,80,57,30,87,426
473,https://images.meesho.com/images/products/16964293/9789a_400.webp,https://www.meesho.com/festive-special-laayna-women-crepe-aline-printed-yellow-kurti/p/a3lqd,₹212,29,14,15,5,6,69
474,https://images.meesho.com/images/products/151913915/gkths_400.webp,https://www.meesho.com/aakarsha-ensemble-kurtis/p/2ig1iz,₹356,71,12,11,8,22,124
475,https://images.meesho.com/images/products/191436413/gowkd_400.webp,https://www.meesho.com/chitrarekha-ensemble-kurtis/p/35z5a5,₹375,3,1,0,0,2,6
476,https://images.meesho.com/images/products/92842300/pjt1g_400.webp,https://www.meesho.com/abhisarika-pretty-kurtis/p/1j9xks,₹532,15,4,5,4,3,31
477,https://images.meesho.com/images/products/148480668/egbom_400.webp,https://www.meesho.com/charvi-pretty-kurtis/p/2gegf0,₹486,0,0,0,0,0,0
478,https://images.meesho.com/images/products/68530435/d4mnb_400.webp,https://www.meesho.com/aagam-drishya-kurtis/p/14suf7,₹351,30,13,12,7,15,77
479,https://images.meesho.com/images/products/181924916/poqu0_400.webp,https://www.meesho.com/kashvi-sensational-kurtis/p/30ba5w,₹521,3,0,0,1,2,6
4710,https://images.meesho.com/images/products/190546964/fcjf2_400.webp,https://www.meesho.com/myra-sensational-kurtis/p/35g2z8,₹416,0,0,0,0,0,0
4711,https://images.meesho.com/images/products/142894412/l1bxj_400.webp,https://www.meesho.com/abhisarika-sensational-kurtis/p/2d2q18,₹439,77,41,19,7,21,165
4712,https://images.meesho.com/images/products/45253315/hxvwg_400.webp,https://www.meesho.com/abhisarika-ensemble-kurtis/p/qxxoj,₹472,313,153,85,22,49,622
4713,https://images.meesho.com/images/products/69307743/2kt7y_400.webp,https://www.meesho.com/kashvi-sensational-kurtis/p/159i73,"₹1,514",2,2,1,0,0,5
4714,https://images.meesho.com/images/products/189010978/yv0fn_400.webp,https://www.meesho.com/trendy-graceful-kurtis/p/34j5sy,₹666,3,0,0,1,0,4
4715,https://images.meesho.com/images/products/9943232/3c0ee_400.webp,https://www.meesho.com/aishani-superior-kurtis/p/5x48w,₹551,14,6,4,2,2,28
4716,https://images.meesho.com/images/products/190629817/ufhu6_400.webp,https://www.meesho.com/chitrarekha-pretty-kurtis/p/35huwp,₹445,0,0,0,0,0,0
4717,https://images.meesho.com/images/products/146145774/q9f8v_400.webp,https://www.meesho.com/adrika-graceful-kurtis/p/2f0esu,₹486,3,3,0,2,1,9
4718,https://images.meesho.com/images/products/15611085/14b79_400.webp,https://www.meesho.com/banita-alluring-kurtis/p/9all9,₹715,357,161,54,40,73,685
4719,https://images.meesho.com/images/products/189681944/diod8_400.webp,https://www.meesho.com/adrika-graceful-kurtis/p/34xjiw,₹349,0,0,0,0,0,0
4720,https://images.meesho.com/images/products/71448665/iugvk_400.webp,https://www.meesho.com/jivika-attractive-kurtis/p/16je55,₹507,55,27,9,4,6,101
481,https://images.meesho.com/images/products/131392186/lwgag_400.webp,https://www.meesho.com/alisha-ensemble-kurtis/p/2686uy,₹367,106,45,33,19,21,224
482,https://images.meesho.com/images/products/181512864/dxqds_400.webp,https://www.meesho.com/aishani-superior-kurtis/p/302g80,₹440,3,1,0,2,1,7
483,https://images.meesho.com/images/products/50936233/n1goq_400.webp,https://www.meesho.com/jivika-superior-kurtis/p/ubqnd,₹456,116,50,29,19,38,252
484,https://images.meesho.com/images/products/43082868/oetuh_400.webp,https://www.meesho.com/adrika-drishya-kurtis/p/pneyc,₹826,18,9,3,3,8,41
485,https://images.meesho.com/images/products/55313644/q0ewh_400.webp,https://www.meesho.com/abhisarika-graceful-kurtis/p/wxka4,₹460,38,17,12,3,13,83
486,https://images.meesho.com/images/products/47085762/6mp0a_400.webp,https://www.meesho.com/jivika-voguish-kurtis/p/s17lu,₹504,9,3,1,1,6,20
487,https://images.meesho.com/images/products/5993284/80a78_400.webp,https://www.meesho.com/women-cotton-aline-chikankari-yellow-kurti/p/3kgg4,₹414,802,408,275,179,269,1933
488,https://images.meesho.com/images/products/27828837/ypjmd_400.webp,https://www.meesho.com/banita-alluring-kurtis/p/gkgv9,₹568,15,6,2,0,2,25
489,https://images.meesho.com/images/products/9955934/9bf95_400.webp,https://www.meesho.com/women-cotton-aline-chikankari-yellow-kurti/p/5xe1q,₹349,39,22,13,4,9,87
4810,https://images.meesho.com/images/products/69878838/sjztq_400.webp,https://www.meesho.com/kashvi-attractive-kurtis/p/15lquu,₹579,589,180,93,49,93,1004
4811,https://images.meesho.com/images/products/140460097/6dkav_400.webp,https://www.meesho.com/abhisarika-attractive-kurtis/p/2bmjpd,₹492,117,69,40,17,56,299
4812,https://images.meesho.com/images/products/180872834/htity_400.webp,https://www.meesho.com/jivika-sensational-kurtis/p/2zoqde,₹460,15,2,3,1,9,30
4813,https://images.meesho.com/images/products/144245375/auroo_400.webp,https://www.meesho.com/trendy-ensemble-kurtis/p/2dvofz,₹292,78,21,29,20,42,190
4814,https://images.meesho.com/images/products/113343521/rdxgw_400.webp,https://www.meesho.com/adrika-refined-kurtis/p/1vhcf5,₹538,35,13,4,6,15,73
4815,https://images.meesho.com/images/products/94170612/ezbj0_400.webp,https://www.meesho.com/chitrarekha-fashionable-kurtis/p/1k2eic,₹616,75,42,17,11,14,159
4816,https://images.meesho.com/images/products/195072330/mnr3h_400.webp,https://www.meesho.com/abhisarika-alluring-kurtis/p/3852ru,₹665,4,1,4,3,1,13
4817,https://images.meesho.com/images/products/153316973/wljuz_400.webp,https://www.meesho.com/alisha-voguish-kurtis/p/2ja44t,₹297,1,1,1,0,2,5
4818,https://images.meesho.com/images/products/72289238/pkoco_400.webp,https://www.meesho.com/banita-superior-kurtis/p/171eqe,₹414,23,23,6,5,10,67
4819,https://images.meesho.com/images/products/112684764/ju1bh_400.webp,https://www.meesho.com/jivika-drishya-kurtis/p/1v384c,₹601,168,63,40,37,60,368
4820,https://images.meesho.com/images/products/182896256/bbsgk_400.webp,https://www.meesho.com/jivika-attractive-kurtis/p/30w3nk,₹489,1,3,0,0,1,5
491,https://images.meesho.com/images/products/167271180/ogfiq_400.webp,https://www.meesho.com/kashvi-ensemble-kurtis/p/2rl79o,₹420,20,8,2,2,3,35
492,https://images.meesho.com/images/products/182977627/upi9k_400.webp,https://www.meesho.com/aakarsha-refined-kurtis/p/30xufv,₹696,4,1,2,0,2,9
493,https://images.meesho.com/images/products/167343838/adrac_400.webp,https://www.meesho.com/myra-ensemble-kurtis/p/2rmrby,₹435,3,4,1,1,2,11
494,https://images.meesho.com/images/products/73312145/g5dtu_400.webp,https://www.meesho.com/trendy-sensational-kurtis/p/17nc0h,₹750,120,50,18,20,29,237
495,https://images.meesho.com/images/products/25787252/mdgzy_400.webp,https://www.meesho.com/zola-georgette-ethinic-wear-lucknowi-chikankari-kurta-for-women/p/fcpkk,"₹1,165",45,11,2,1,3,62
496,https://images.meesho.com/images/products/159813963/fdniq_400.webp,https://www.meesho.com/banita-attractive-kurtis/p/2n5d8r,₹497,14,3,6,2,5,30
497,https://images.meesho.com/images/products/142655583/hexpi_400.webp,https://www.meesho.com/aakarsha-drishya-kurtis/p/2cxlr3,₹318,15,4,1,1,2,23
498,https://images.meesho.com/images/products/67210071/wryly_400.webp,https://www.meesho.com/aagam-refined-kurtis/p/140jmf,₹297,63,24,26,12,39,164
499,https://images.meesho.com/images/products/172938142/2u1gk_400.webp,https://www.meesho.com/adrika-alluring-kurtis/p/2uynxa,₹511,17,4,6,0,10,37
4910,https://images.meesho.com/images/products/56025207/ig6qc_400.webp,https://www.meesho.com/chitrarekha-petite-kurtis/p/xctbr,₹453,1,2,1,0,0,4
4911,https://images.meesho.com/images/products/160358099/mkzhi_400.webp,https://www.meesho.com/chitrarekha-ensemble-kurtis/p/2nh13n,₹299,2,1,1,0,0,4
4912,https://images.meesho.com/images/products/186861329/muzk7_400.webp,https://www.meesho.com/jivika-attractive-kurtis/p/33934h,₹463,2,2,2,1,2,9
4913,https://images.meesho.com/images/products/156947161/189kw_400.webp,https://www.meesho.com/abhisarika-attractive-kurtis/p/2lfx7d,₹348,12,5,4,0,2,23
4914,https://images.meesho.com/images/products/160397978/ca2jp_400.webp,https://www.meesho.com/aagyeyi-drishya-kurtis/p/2nhvve,₹451,6,3,1,1,2,13
4915,https://images.meesho.com/images/products/167288971/lo4nh_400.webp,https://www.meesho.com/aagyeyi-attractive-kurtis/p/2rlkzv,₹420,23,3,4,2,6,38
4916,https://images.meesho.com/images/products/162575999/asm55_400.webp,https://www.meesho.com/aishani-ensemble-kurtis/p/2oskfz,₹565,32,19,7,5,9,72
4917,https://images.meesho.com/images/products/167234973/u5dbl_400.webp,https://www.meesho.com/banita-superior-kurtis/p/2rkfbx,₹374,7,1,2,2,4,16
4918,https://images.meesho.com/images/products/178670047/i7ggu_400.webp,https://www.meesho.com/abhisarika-pretty-kurtis/p/2ydiov,₹361,13,1,0,2,3,19
4919,https://images.meesho.com/images/products/178774858/rdofo_400.webp,https://www.meesho.com/aagam-graceful-kurtis/p/2yfrka,₹665,16,7,3,2,4,32
4920,https://images.meesho.com/images/products/196856323/varda_400.webp,https://www.meesho.com/aagyeyi-ensemble-kurtis/p/397bb7,₹294,1,1,1,2,0,5
501,https://images.meesho.com/images/products/108818189/ccmva_400.webp,https://www.meesho.com/alisha-petite-kurtis/p/1sscnh,₹579,159,60,44,13,62,338
502,https://images.meesho.com/images/products/196869528/btnfp_400.webp,https://www.meesho.com/jivika-attractive-kurtis/p/397li0,₹731,5,2,1,1,3,12
503,https://images.meesho.com/images/products/181252520/snuxb_400.webp,https://www.meesho.com/myra-pretty-kurtis/p/2zwvc8,₹464,9,2,2,2,4,19
504,https://images.meesho.com/images/products/197659371/egc5m_400.webp,https://www.meesho.com/aagam-graceful-kurtis/p/39oiy3,₹437,0,0,0,0,0,0
505,https://images.meesho.com/images/products/66030364/tvet0_400.webp,https://www.meesho.com/chitrarekha-fashionable-kurtis/p/13b9cs,₹865,57,14,4,8,14,97
506,https://images.meesho.com/images/products/182325251/zhwvs_400.webp,https://www.meesho.com/jivika-superior-kurtis/p/30jv2b,₹444,7,3,1,0,1,12
507,https://images.meesho.com/images/products/45414319/pyqfi_400.webp,https://www.meesho.com/alisha-voguish-kurtis/p/r1dwv,₹499,314,153,102,49,121,739
508,https://images.meesho.com/images/products/39352427/prw16_400.webp,https://www.meesho.com/kashvi-drishya-kurtis/p/nfgiz,₹359,19,7,3,3,5,37
509,https://images.meesho.com/images/products/178898149/evkm8_400.webp,https://www.meesho.com/abhisarika-drishya-kurtis/p/2yiep1,₹615,5,2,0,0,2,9
5010,https://images.meesho.com/images/products/77707611/uq63c_400.webp,https://www.meesho.com/myra-drishya-kurtis/p/1a9jkr,₹563,222,97,62,50,74,505
5011,https://images.meesho.com/images/products/113664775/8quwz_400.webp,https://www.meesho.com/charvi-fashionable-kurtis/p/1vo8av,₹585,8,1,0,0,4,13
5012,https://images.meesho.com/images/products/42078736/zg7xh_400.webp,https://www.meesho.com/aakarsha-fashionable-kurtis/p/p1w5s,₹362,31,11,13,10,4,69
5013,https://images.meesho.com/images/products/16332261/b6dcf_400.webp,https://www.meesho.com/women-cotton-aline-chikankari-yellow-kurti/p/9q21x,₹395,10,7,3,1,3,24
5014,https://images.meesho.com/images/products/55449568/emknl_400.webp,https://www.meesho.com/abhisarika-fabulous-kurtis/p/x0h5s,₹600,161,81,45,31,57,375
5015,https://images.meesho.com/images/products/161733608/vozat_400.webp,https://www.meesho.com/aishani-voguish-kurtis/p/2oaig8,₹526,9,3,3,0,6,21
5016,https://images.meesho.com/images/products/51456137/ehf3k_400.webp,https://www.meesho.com/myra-attractive-kurtis/p/umvt5,₹765,12,3,6,1,8,30
5017,https://images.meesho.com/images/products/145117345/ysuhn_400.webp,https://www.meesho.com/charvi-attractive-kurtis/p/2eed9d,₹518,13,8,2,2,9,34
5018,https://images.meesho.com/images/products/145384711/pzhzy_400.webp,https://www.meesho.com/aagyeyi-refined-kurtis/p/2ek3k7,₹532,22,12,6,4,5,49
5019,https://images.meesho.com/images/products/63388734/bgdzl_400.webp,https://www.meesho.com/myra-voguish-kurtis/p/11qn26,₹431,81,25,39,27,32,204
5020,https://images.meesho.com/images/products/17242861/7fbfe_400.webp,https://www.meesho.com/women-cotton-blend-aline-embroidered-yellow-kurti/p/a9kod,₹355,26,19,5,2,7,59
511,https://images.meesho.com/images/products/7366599/cc22a_400.webp,https://www.meesho.com/charvi-fashionable-kurtis/p/4dw3r,₹605,202,86,55,36,46,425
512,https://images.meesho.com/images/products/68312645/gifoz_400.webp,https://www.meesho.com/charvi-fashionable-kurtis/p/14o6dh,₹573,218,98,49,40,80,485
513,https://images.meesho.com/images/products/47110336/b2l0k_400.webp,https://www.meesho.com/myra-attractive-kurtis/p/s1qkg,₹715,41,19,4,4,11,79
514,https://images.meesho.com/images/products/128738539/audm9_400.webp,https://www.meesho.com/aagyeyi-graceful-kurtis/p/24nbaj,₹237,11,2,1,0,4,18
515,https://images.meesho.com/images/products/156229724/supca_400.webp,https://www.meesho.com/abhisarika-graceful-kurtis/p/2l0jmk,₹274,14,11,5,3,12,45
516,https://images.meesho.com/images/products/47246369/lhkbg_400.webp,https://www.meesho.com/aakarsha-sensational-kurtis/p/s4nj5,₹540,9,1,2,0,2,14
517,https://images.meesho.com/images/products/43551496/7iqb4_400.webp,https://www.meesho.com/adrika-fabulous-kurtis/p/pxgjs,₹941,6,1,0,1,2,10
518,https://images.meesho.com/images/products/56275196/fyc0o_400.webp,https://www.meesho.com/aakarsha-fashionable-kurtis/p/xi67w,₹574,45,23,8,0,2,78
519,https://images.meesho.com/images/products/73116889/rt0gc_400.webp,https://www.meesho.com/jivika-fashionable-kurtis/p/17j5cp,₹450,6,0,1,1,1,9
5110,https://images.meesho.com/images/products/22896078/0caaf_400.webp,https://www.meesho.com/jivika-voguish-kurtis/p/dmqq6,₹831,14,1,1,3,4,23
5111,https://images.meesho.com/images/products/68885466/dvzj9_400.webp,https://www.meesho.com/adrika-pretty-kurtis/p/150gd6,₹303,3,1,0,0,1,5
5112,https://images.meesho.com/images/products/47041403/kqmjr_400.webp,https://www.meesho.com/alisha-pretty-kurtis/p/s09dn,₹539,84,19,19,17,31,170
5113,https://images.meesho.com/images/products/12540746/7dfe6_400.webp,https://www.meesho.com/myra-pretty-kurtis/p/7gsi2,₹583,3,1,0,0,0,4
5114,https://images.meesho.com/images/products/41652195/hdh9x_400.webp,https://www.meesho.com/chitrarekha-refined-kurtis/p/osr1f,₹614,13,4,3,5,3,28
5115,https://images.meesho.com/images/products/44872157/vipep_400.webp,https://www.meesho.com/aagam-refined-kurtis/p/qprkt,₹771,5,1,0,0,1,7
5116,https://images.meesho.com/images/products/75466477/c3p6p_400.webp,https://www.meesho.com/jivika-alluring-kurtis/p/18xib1,₹494,7,1,0,0,2,10
5117,https://images.meesho.com/images/products/43769792/0nkrv_400.webp,https://www.meesho.com/adrika-voguish-kurtis/p/q24zk,"₹1,131",10,2,0,1,0,13
5118,https://images.meesho.com/images/products/47672364/musza_400.webp,https://www.meesho.com/charvi-petite-kurtis/p/sds8c,₹352,17,4,5,2,5,33
5119,https://images.meesho.com/images/products/183049314/8jwry_400.webp,https://www.meesho.com/adrika-ensemble-kurtis/p/30zdr6,₹601,3,0,1,0,0,4
5120,https://images.meesho.com/images/products/181429754/buqzc_400.webp,https://www.meesho.com/aagam-pretty-kurtis/p/300o3e,₹366,0,0,0,0,0,0
521,https://images.meesho.com/images/products/181429754/buqzc_400.webp,https://www.meesho.com/aagam-pretty-kurtis/p/300o3e,₹366,0,0,0,0,0,0
522,https://images.meesho.com/images/products/194699333/vltr3_400.webp,https://www.meesho.com/adrika-refined-kurtis/p/37x2yt,₹550,0,0,0,0,0,0
523,https://images.meesho.com/images/products/193147063/yojlp_400.webp,https://www.meesho.com/trendy-petite-kurtis/p/36zt87,₹485,0,0,0,0,0,0
524,https://images.meesho.com/images/products/146140530/tgs08_400.webp,https://www.meesho.com/jivika-superior-kurtis/p/2f0ar6,₹473,0,0,0,0,0,0
525,https://images.meesho.com/images/products/150864401/mlz4t_400.webp,https://www.meesho.com/trendy-ensemble-kurtis/p/2htjpt,₹292,14,3,3,1,1,22
526,https://images.meesho.com/images/products/167357166/btrbu_400.webp,https://www.meesho.com/myra-graceful-kurtis/p/2rn1m6,₹454,0,0,0,0,0,0
527,https://images.meesho.com/images/products/160633512/atshl_400.webp,https://www.meesho.com/banita-fashionable-kurtis/p/2nmxm0,₹909,0,0,0,0,0,0
528,https://images.meesho.com/images/products/186814781/b9exo_400.webp,https://www.meesho.com/kashvi-refined-kurtis/p/33837h,₹685,0,0,0,0,0,0
529,https://images.meesho.com/images/products/182078196/ubjyl_400.webp,https://www.meesho.com/banita-superior-kurtis/p/30ekfo,₹404,4,4,0,1,0,9
5210,https://images.meesho.com/images/products/196682523/5n0xn_400.webp,https://www.meesho.com/banita-alluring-kurtis/p/393l7f,₹565,3,1,1,0,0,5
5211,https://images.meesho.com/images/products/159258089/muh7g_400.webp,https://www.meesho.com/charvi-sensational-kurtis/p/2mtgbt,₹484,6,2,2,2,0,12
5212,https://images.meesho.com/images/products/156953599/0fejt_400.webp,https://www.meesho.com/trendy-petite-kurtis/p/2lg267,₹354,0,0,0,0,0,0
5213,https://images.meesho.com/images/products/143650955/vfdpt_400.webp,https://www.meesho.com/jivika-alluring-kurtis/p/2dixsb,₹845,5,2,0,1,1,9
5214,https://images.meesho.com/images/products/140072228/u6fsa_400.webp,https://www.meesho.com/trendy-fashionable-kurtis/p/2be8f8,₹577,3,0,0,0,1,4
5215,https://images.meesho.com/images/products/170832785/nr0kd_400.webp,https://www.meesho.com/chitrarekha-petite-kurtis/p/2tpjf5,₹701,15,3,3,1,2,24
5216,https://images.meesho.com/images/products/192452140/hrmi5_400.webp,https://www.meesho.com/adrika-pretty-kurtis/p/36kx0s,₹308,0,0,0,0,0,0
5217,https://images.meesho.com/images/products/120813379/ykkkb_400.webp,https://www.meesho.com/abhisarika-alluring-kurtis/p/1zxg77,₹937,4,0,1,0,1,6
5218,https://images.meesho.com/images/products/159973268/lu2kr_400.webp,https://www.meesho.com/abhisarika-fabulous-kurtis/p/2n8s5w,₹566,2,0,2,0,0,4
5219,https://images.meesho.com/images/products/125644061/x7wnx_400.webp,https://www.meesho.com/trendy-attractive-kurtis/p/22szkt,₹464,3,1,0,0,0,4
5220,https://images.meesho.com/images/products/167536374/sfd5k_400.webp,https://www.meesho.com/abhisarika-superior-kurtis/p/2rqvw6,₹765,0,0,0,0,0,0
541,https://images.meesho.com/images/products/130247036/isjcv_400.webp,https://www.meesho.com/festive-special-aagyeyi-superior-kurtis/p/25jn98,₹343,37,22,6,2,11,78
542,https://images.meesho.com/images/products/62267974/78rd1_400.webp,https://www.meesho.com/trendy-sensational-kurtis/p/112m9y,₹532,14,13,7,2,2,38
543,https://images.meesho.com/images/products/73422774/ds6lk_400.webp,https://www.meesho.com/aakarsha-voguish-kurtis/p/17ppdi,₹536,6,3,1,0,2,12
544,https://images.meesho.com/images/products/170634928/zsqbd_400.webp,https://www.meesho.com/chitrarekha-sensational-kurtis/p/2tlar4,₹686,22,6,8,3,4,43
545,https://images.meesho.com/images/products/133520315/xrx9v_400.webp,https://www.meesho.com/festive-special-chitrarekha-alluring-kurtis/p/27hsxn,₹480,29,8,6,5,6,54
546,https://images.meesho.com/images/products/129532076/zlt7r_400.webp,https://www.meesho.com/aagyeyi-pretty-kurtis/p/254bl8,₹464,0,0,0,0,0,0
547,https://images.meesho.com/images/products/63014501/vxcss_400.webp,https://www.meesho.com/banita-graceful-kurtis/p/11imat,₹378,60,23,18,11,35,147
548,https://images.meesho.com/images/products/105770674/nlbvp_400.webp,https://www.meesho.com/aagam-refined-kurtis/p/1qz16a,₹499,281,114,65,33,82,575
549,https://images.meesho.com/images/products/171409940/zlni1_400.webp,https://www.meesho.com/charvi-alluring-kurtis/p/2u1wr8,₹538,5,0,1,1,1,8
5410,https://images.meesho.com/images/products/167841178/hprsh_400.webp,https://www.meesho.com/aakarsha-refined-kurtis/p/2rxf2y,₹611,14,6,5,2,3,30
5411,https://images.meesho.com/images/products/4407517/2_400.webp,https://www.meesho.com/ria-refined-kurtis-vol-5/p/2mgv1,₹414,20,4,8,5,3,40
5412,https://images.meesho.com/images/products/18628944/8b295_400.webp,https://www.meesho.com/aakarsha-pretty-kurtis/p/b3a6o,₹344,53,19,16,7,22,117
5413,https://images.meesho.com/images/products/40178099/5icue_400.webp,https://www.meesho.com/aakarsha-petite-kurtis/p/nx5mb,₹350,213,78,52,39,49,431
5414,https://images.meesho.com/images/products/73678184/yvqby_400.webp,https://www.meesho.com/jivika-petite-kurtis/p/17v6g8,₹515,39,15,12,7,10,83
5415,https://images.meesho.com/images/products/58295065/nfy6g_400.webp,https://www.meesho.com/aakarsha-sensational-kurtis/p/ypgrd,₹437,27,9,5,2,10,53
5416,https://images.meesho.com/images/products/26743393/199f0_400.webp,https://www.meesho.com/jivika-fashionable-kurtis/p/fx7c1,₹259,530,183,137,83,130,1063
5417,https://images.meesho.com/images/products/159694089/lbj7v_400.webp,https://www.meesho.com/adrika-refined-kurtis/p/2n2sqx,"₹1,000",5,3,1,0,2,11
5418,https://images.meesho.com/images/products/52317023/qxptr_400.webp,https://www.meesho.com/myra-alluring-kurtis/p/v5c2n,₹549,64,36,18,6,18,142
5419,https://images.meesho.com/images/products/14238783/2e5fc_400.webp,https://www.meesho.com/women-georgette-straight-chikankari-yellow-kurti/p/8h6pr,₹587,316,122,70,55,86,649
5420,https://images.meesho.com/images/products/130788326/u9phl_400.webp,https://www.meesho.com/aagyeyi-pretty-kurtis/p/25v8x2,₹464,19,6,4,2,5,36
561,https://images.meesho.com/images/products/125625963/j7qrz_400.webp,https://www.meesho.com/abhisarika-voguish-kurtis/p/22slm3,₹213,9,2,4,1,3,19
562,https://images.meesho.com/images/products/112258848/xpduz_400.webp,https://www.meesho.com/alisha-fashionable-kurtis/p/1uu3hc,₹582,133,53,40,26,47,299
563,https://images.meesho.com/images/products/181924911/q2cif_400.webp,https://www.meesho.com/trendy-pretty-kurtis/p/30ba5r,₹521,0,0,0,0,0,0
564,https://images.meesho.com/images/products/142740320/yepok_400.webp,https://www.meesho.com/aagyeyi-voguish-kurtis/p/2czf4w,₹296,0,0,0,0,0,0
565,https://images.meesho.com/images/products/182070434/vs7eg_400.webp,https://www.meesho.com/abhisarika-refined-kurtis/p/30eeg2,₹540,0,0,0,0,0,0
566,https://images.meesho.com/images/products/12541442/abgdf_400.webp,https://www.meesho.com/trendy-petite-kurtis/p/7gt1e,₹581,113,68,34,18,23,256
567,https://images.meesho.com/images/products/113816396/kgnre_400.webp,https://www.meesho.com/adrika-voguish-kurtis/p/1vrhak,₹589,52,21,12,11,20,116
568,https://images.meesho.com/images/products/29135286/f1c53_400.webp,https://www.meesho.com/jivika-sensational-kurtis/p/hcgxi,₹585,38,10,7,6,12,73
569,https://images.meesho.com/images/products/68505033/bjp4w_400.webp,https://www.meesho.com/kashvi-refined-kurtis/p/14satl,₹526,117,49,29,19,46,260
5610,https://images.meesho.com/images/products/141522103/wb87h_400.webp,https://www.meesho.com/aakarsha-superior-kurtis/p/2c9b5j,₹353,21,9,6,4,8,48
5611,https://images.meesho.com/images/products/118705339/p3a2y_400.webp,https://www.meesho.com/banita-graceful-kurtis/p/1yo9mj,₹543,35,15,13,6,13,82
5612,https://images.meesho.com/images/products/116512948/v3jng_400.webp,https://www.meesho.com/chitrarekha-refined-kurtis/p/1xd9ys,₹486,6,1,5,0,2,14
5613,https://images.meesho.com/images/products/16268495/66681_400.webp,https://www.meesho.com/myra-voguish-kurtis/p/9ooun,₹935,41,11,8,3,22,85
5614,https://images.meesho.com/images/products/78494764/xsyv8_400.webp,https://www.meesho.com/kashvi-drishya-kurtis/p/1aqey4,₹343,197,98,69,37,73,474
5615,https://images.meesho.com/images/products/64160698/mwfcp_400.webp,https://www.meesho.com/aagyeyi-pretty-kurtis/p/1276pm,₹309,0,0,0,0,0,0
5616,https://images.meesho.com/images/products/42232978/nixgz_400.webp,https://www.meesho.com/jivika-fashionable-kurtis/p/p576a,₹701,19,7,8,1,4,39
5617,https://images.meesho.com/images/products/49149913/58uo3_400.webp,https://www.meesho.com/chitrarekha-superior-kurtis/p/t9gbd,₹413,0,0,0,0,0,0
5618,https://images.meesho.com/images/products/72898390/adrm8_400.webp,https://www.meesho.com/aagam-attractive-kurtis/p/17egra,₹532,0,0,0,0,0,0
5619,https://images.meesho.com/images/products/16025399/dc7b1_400.webp,https://www.meesho.com/trendy-alluring-kurtis/p/9jh9z,₹629,14,3,0,2,8,27
5620,https://images.meesho.com/images/products/70715554/9xr1s_400.webp,https://www.meesho.com/chitrarekha-ensemble-kurtis/p/163ogy,₹437,0,0,0,0,0,0
571,https://images.meesho.com/images/products/55430349/rwjls_400.webp,https://www.meesho.com/kashvi-superior-kurtis/p/x02bx,₹513,0,0,0,0,0,0
572,https://images.meesho.com/images/products/6464586/77b2f_400.webp,https://www.meesho.com/women-cotton-aline-chikankari-yellow-kurti/p/3uk3u,₹527,2,0,1,0,3,6
573,https://images.meesho.com/images/products/53559797/ot7hs_400.webp,https://www.meesho.com/aishani-sensational-kurtis/p/vvz05,₹267,0,0,0,0,0,0
574,https://images.meesho.com/images/products/41743486/iywop_400.webp,https://www.meesho.com/aagyeyi-fabulous-kurtis/p/oupha,₹425,0,0,0,0,0,0
575,https://images.meesho.com/images/products/13942541/38ebb_400.webp,https://www.meesho.com/kashvi-attractive-kurtis/p/8au4t,₹665,0,0,0,0,0,0
576,https://images.meesho.com/images/products/31121224/a0b9a_400.webp,https://www.meesho.com/abhisarika-voguish-kurtis/p/ij1ag,₹576,0,0,0,0,0,0
577,https://images.meesho.com/images/products/65791660/es5qw_400.webp,https://www.meesho.com/abhisarika-drishya-kurtis/p/136564,₹532,0,0,0,0,0,0
578,https://images.meesho.com/images/products/69614789/nnf0w_400.webp,https://www.meesho.com/abhisarika-attractive-kurtis/p/15g345,₹536,0,0,0,0,0,0
579,https://images.meesho.com/images/products/183039071/rpnqq_400.webp,https://www.meesho.com/aagam-voguish-kurtis/p/30z5un,₹442,0,0,0,0,0,0
5710,https://images.meesho.com/images/products/195480081/eth10_400.webp,https://www.meesho.com/abhisarika-fashionable-kurtis/p/38dte9,₹413,0,0,0,0,0,0
5711,https://images.meesho.com/images/products/181949609/xaats_400.webp,https://www.meesho.com/chitrarekha-superior-kurtis/p/30bt7t,₹641,0,0,0,0,0,0
5712,https://images.meesho.com/images/products/190449853/wkvba_400.webp,https://www.meesho.com/myra-ensemble-kurtis/p/35e01p,₹591,0,0,0,0,0,0
5713,https://images.meesho.com/images/products/190380376/6wlft_400.webp,https://www.meesho.com/alisha-sensational-kurtis/p/35cifs,₹551,0,0,0,0,0,0
5714,https://images.meesho.com/images/products/159872730/5rboy_400.webp,https://www.meesho.com/jivika-refined-kurtis/p/2n6ml6,₹516,0,0,0,0,0,0
5715,https://images.meesho.com/images/products/165774087/tyyvv_400.webp,https://www.meesho.com/adrika-attractive-kurtis/p/2qp43r,₹435,0,0,0,0,0,0
5716,https://images.meesho.com/images/products/174495649/114g0_400.webp,https://www.meesho.com/trendy-voguish-kurtis/p/2vw1pd,₹765,0,0,0,0,0,0
5717,https://images.meesho.com/images/products/171271830/pooku_400.webp,https://www.meesho.com/charvi-graceful-kurtis/p/2tyy6u,₹492,0,0,0,0,0,0
5718,https://images.meesho.com/images/products/177005095/icqcx_400.webp,https://www.meesho.com/aakarsha-fabulous-kurtis/p/2xdu07,₹596,0,0,0,0,0,0
5719,https://images.meesho.com/images/products/180966000/niclz_400.webp,https://www.meesho.com/jivika-graceful-kurtis/p/2zqq9c,₹340,0,0,0,0,0,0
5720,https://images.meesho.com/images/products/189300051/vhrmy_400.webp,https://www.meesho.com/aagyeyi-attractive-kurtis/p/34pcur,₹464,0,0,0,0,0,0
581,https://images.meesho.com/images/products/182710781/msjqn_400.webp,https://www.meesho.com/chitrarekha-voguish-kurtis/p/30s4jh,₹506,0,0,0,0,0,0
582,https://images.meesho.com/images/products/195841895/t6i4h_400.webp,https://www.meesho.com/jivika-refined-kurtis/p/38lkkn,₹555,0,0,0,0,0,0
583,https://images.meesho.com/images/products/177308480/hftyn_400.webp,https://www.meesho.com/jivika-graceful-kurtis/p/2xkc3k,₹586,0,0,0,0,0,0
584,https://images.meesho.com/images/products/164495946/sy08d_400.webp,https://www.meesho.com/aakarsha-alluring-kurtis/p/2pxpvu,₹362,0,0,0,0,0,0
585,https://images.meesho.com/images/products/153715436/ejbra_400.webp,https://www.meesho.com/abhisarika-refined-kurtis/p/2jinl8,₹535,0,0,0,0,0,0
586,https://images.meesho.com/images/products/158158530/8moba_400.webp,https://www.meesho.com/kashvi-ensemble-kurtis/p/2m5vwi,₹551,0,0,0,0,0,0
587,https://images.meesho.com/images/products/170539083/yow5t_400.webp,https://www.meesho.com/aakarsha-petite-kurtis/p/2tj8sr,₹347,0,0,0,0,0,0
588,https://images.meesho.com/images/products/166813704/ipxlo_400.webp,https://www.meesho.com/adrika-ensemble-kurtis/p/2rbea0,₹321,0,0,0,0,0,0
589,https://images.meesho.com/images/products/161406099/piuko_400.webp,https://www.meesho.com/charvi-refined-kurtis/p/2o3hqr,₹537,0,0,0,0,0,0
5810,https://images.meesho.com/images/products/176191039/rfzk1_400.webp,https://www.meesho.com/adrika-graceful-kurtis/p/2wwdvj,₹644,0,0,0,0,0,0
5811,https://images.meesho.com/images/products/121815626/a4bvs_400.webp,https://www.meesho.com/aishani-ensemble-kurtis/p/20ixje,₹247,0,0,0,0,0,0
5812,https://images.meesho.com/images/products/174283228/dvflt_400.webp,https://www.meesho.com/charvi-fashionable-kurtis/p/2vrhss,₹306,0,0,0,0,0,0
5813,https://images.meesho.com/images/products/172020357/dbz5y_400.webp,https://www.meesho.com/abhisarika-petite-kurtis/p/2uezr9,₹464,0,0,0,0,0,0
5814,https://images.meesho.com/images/products/164314200/haoxt_400.webp,https://www.meesho.com/abhisarika-graceful-kurtis/p/2pttnc,₹464,0,0,0,0,0,0
5815,https://images.meesho.com/images/products/190579392/pnlgy_400.webp,https://www.meesho.com/chitrarekha-sensational-kurtis/p/35gs00,₹416,0,0,0,0,0,0
5816,https://images.meesho.com/images/products/191104038/dfitg_400.webp,https://www.meesho.com/abhisarika-pretty-kurtis/p/35s0ti,₹250,0,0,0,0,0,0
5817,https://images.meesho.com/images/products/155563719/xewlm_400.webp,https://www.meesho.com/jivika-fabulous-kurtis/p/2km9qf,₹666,0,0,0,0,0,0
5818,https://images.meesho.com/images/products/125658207/6v4ux_400.webp,https://www.meesho.com/myra-refined-kurtis/p/22tahr,₹442,0,0,0,0,0,0
5819,https://images.meesho.com/images/products/144971914/dytxv_400.webp,https://www.meesho.com/kashvi-superior-kurtis/p/2eb91m,₹515,0,0,0,0,0,0
5820,https://images.meesho.com/images/products/153475319/u4cna_400.webp,https://www.meesho.com/charvi-fabulous-kurtis/p/2jdibb,₹543,0,0,0,0,0,0
591,https://images.meesho.com/images/products/172785296/6jepq_400.webp,https://www.meesho.com/abhisarika-refined-kurtis/p/2uvdzk,₹482,0,0,0,0,0,0
592,https://images.meesho.com/images/products/165268121/nklov_400.webp,https://www.meesho.com/chitrarekha-superior-kurtis/p/2qe9p5,₹520,0,0,0,0,0,0
593,https://images.meesho.com/images/products/148035409/hvywe_400.webp,https://www.meesho.com/banita-alluring-kurtis/p/2g4wup,₹515,0,0,0,0,0,0
594,https://images.meesho.com/images/products/170135206/spp4w_400.webp,https://www.meesho.com/jivika-pretty-kurtis/p/2tal5y,₹614,0,0,0,0,0,0
595,https://images.meesho.com/images/products/169477048/9udpo_400.webp,https://www.meesho.com/myra-drishya-kurtis/p/2swhbs,₹541,0,0,0,0,0,0
596,https://images.meesho.com/images/products/146210656/3x5ju_400.webp,https://www.meesho.com/aakarsha-fabulous-kurtis/p/2f1sv4,₹540,0,0,0,0,0,0
597,https://images.meesho.com/images/products/154478455/j9j3v_400.webp,https://www.meesho.com/kashvi-superior-kurtis/p/2jz0c7,₹569,0,0,0,0,0,0
598,https://images.meesho.com/images/products/189969983/dvsjq_400.webp,https://www.meesho.com/aagyeyi-sensational-kurtis/p/353prz,₹444,0,0,0,0,0,0
599,https://images.meesho.com/images/products/151127971/zm7yd_400.webp,https://www.meesho.com/aagyeyi-alluring-kurtis/p/2hz737,₹383,0,0,0,0,0,0
5910,https://images.meesho.com/images/products/187407140/cq0cu_400.webp,https://www.meesho.com/adrika-fashionable-kurtis/p/33ks9w,₹292,0,0,0,0,0,0
5911,https://images.meesho.com/images/products/172377857/gae2a_400.webp,https://www.meesho.com/myra-sensational-kurtis/p/2umnlt,₹591,0,0,0,0,0,0
5912,https://images.meesho.com/images/products/130499287/2dzht_400.webp,https://www.meesho.com/aishani-alluring-kurtis/p/25p1w7,₹471,0,0,0,0,0,0
5913,https://images.meesho.com/images/products/180108414/svfzd_400.webp,https://www.meesho.com/trendy-voguish-kurtis/p/2z8cji,₹715,0,0,0,0,0,0
5914,https://images.meesho.com/images/products/181010915/gh2ea_400.webp,https://www.meesho.com/aishani-voguish-kurtis/p/2zrowz,₹409,0,0,0,0,0,0
5915,https://images.meesho.com/images/products/126937630/vpi0q_400.webp,https://www.meesho.com/aishani-sensational-kurtis/p/23kppa,₹170,32,12,15,2,14,75
5916,https://images.meesho.com/images/products/144646005/nsoa1_400.webp,https://www.meesho.com/alisha-petite-kurtis/p/2e49kl,₹918,9,2,5,0,4,20
5917,https://images.meesho.com/images/products/146215375/ktmw5_400.webp,https://www.meesho.com/chitrarekha-ensemble-kurtis/p/2f1wi7,₹476,0,0,0,0,0,0
5918,https://images.meesho.com/images/products/8501624/23c94_400.webp,https://www.meesho.com/women-rayon-aline-chikankari-yellow-kurti/p/527w8,₹414,1374,599,402,233,351,2959
5919,https://images.meesho.com/images/products/43808201/uriye_400.webp,https://www.meesho.com/abhisarika-sensational-kurtis/p/q2ymh,₹786,34,6,6,3,10,59
5920,https://images.meesho.com/images/products/54980768/y0pu4_400.webp,https://www.meesho.com/festive-special-adrika-refined-kurtis/p/wqffk,₹327,99,41,41,20,41,242
601,https://images.meesho.com/images/products/141209375/uqosk_400.webp,https://www.meesho.com/abhisarika-fabulous-kurtis/p/2c2lun,₹756,49,12,10,5,12,88
602,https://images.meesho.com/images/products/51475376/sgd7a_400.webp,https://www.meesho.com/jivika-superior-kurtis/p/unank,₹746,8,2,1,1,2,14
603,https://images.meesho.com/images/products/42026018/3ffgb_400.webp,https://www.meesho.com/aakarsha-ensemble-kurtis/p/p0rhe,₹429,5,1,3,0,3,12
604,https://images.meesho.com/images/products/77767717/2taqu_400.webp,https://www.meesho.com/myra-ensemble-kurtis/p/1aatyd,₹379,26,10,12,5,8,61
605,https://images.meesho.com/images/products/150105082/ygxmr_400.webp,https://www.meesho.com/banita-superior-kurtis/p/2hd9tm,₹321,3,0,3,0,1,7
606,https://images.meesho.com/images/products/141652036/imxhv_400.webp,https://www.meesho.com/myra-petite-kurtis/p/2cc3es,₹601,2,3,0,1,1,7
607,https://images.meesho.com/images/products/112563581/4znq5_400.webp,https://www.meesho.com/alisha-sensational-kurtis/p/1v0mm5,₹362,6,4,2,1,3,16
608,https://images.meesho.com/images/products/80935356/qcvg7_400.webp,https://www.meesho.com/kashvi-voguish-kurtis/p/1c6q4c,₹507,37,11,16,4,16,84
609,https://images.meesho.com/images/products/13997897/2191c_400.webp,https://www.meesho.com/kashvi-refined-kurtis/p/8c0uh,₹467,583,222,134,75,192,1206
6010,https://images.meesho.com/images/products/194698357/ubzwu_400.webp,https://www.meesho.com/chitrarekha-voguish-kurtis/p/37x27p,₹956,2,1,0,0,2,5
6011,https://images.meesho.com/images/products/87242985/4dtgg_400.webp,https://www.meesho.com/aagam-drishya-kurtis/p/1fxx49,₹526,31,9,3,8,14,65
6012,https://images.meesho.com/images/products/73421727/rohep_400.webp,https://www.meesho.com/trendy-fabulous-kurtis/p/17pokf,₹299,49,23,19,8,21,120
6013,https://images.meesho.com/images/products/159898544/qt2a9_400.webp,https://www.meesho.com/jivika-voguish-kurtis/p/2n76i8,₹507,7,2,4,1,3,17
6014,https://images.meesho.com/images/products/48076357/wlhkk_400.webp,https://www.meesho.com/trendy-superior-kurtis/p/smfyd,₹531,0,0,0,0,0,0
6015,https://images.meesho.com/images/products/54139736/opiec_400.webp,https://www.meesho.com/myra-fabulous-kurtis/p/w8ehk,₹344,0,0,0,0,0,0
6016,https://images.meesho.com/images/products/64544417/akf5w_400.webp,https://www.meesho.com/aagam-fashionable-kurtis/p/12fesh,₹479,0,0,0,0,0,0
6017,https://images.meesho.com/images/products/62310868/cxzk9_400.webp,https://www.meesho.com/chitrarekha-ensemble-kurtis/p/113jdg,₹368,5,1,1,1,1,9
6018,https://images.meesho.com/images/products/52045252/efqbs_400.webp,https://www.meesho.com/aagyeyi-fashionable-kurtis/p/uzidg,₹533,1,3,0,1,0,5
6019,https://images.meesho.com/images/products/121018296/qozhb_400.webp,https://www.meesho.com/abhisarika-graceful-kurtis/p/201ubc,₹565,2,2,5,1,0,10
6020,https://images.meesho.com/images/products/149696210/902ja_400.webp,https://www.meesho.com/chitrarekha-pretty-kurtis/p/2h4ic2,₹464,0,0,0,0,0,0
